TTTTCATCTCGTTGCCGGTG -> TTTCATCTCGTTGCCGGTGG
TCGTTGCCGGTGGAGATGCG -> CGTTGCCGGTGGAGATGCGA
CTCGTATTCGAGGTACCCGA -> TCGTATTCGAGGTACCCGAG
AGCCCTTAGTTTCCTCTATT -> GCCCTTAGTTTCCTCTATTA
AATAACTGTTGAGTCTAATC -> ATAACTGTTGAGTCTAATCT
CTCACTTAGTCTGTGTGTAG -> TCACTTAGTCTGTGTGTAGG
AAGTGCCAGCCTAATCCCAT -> AGTGCCAGCCTAATCCCATT
TCGTCGTAGCGACAATTGTT -> CGTCGTAGCGACAATTGTTG
GTTCGGAGGGGCGGGTGCGC -> TTCGGAGGGGCGGGTGCGCA
CCCCGGTGAGATCATCCAAG -> CCCGGTGAGATCATCCAAGC
GCGATGGAGGGTCGAACCAC -> CGATGGAGGGTCGAACCACT
TCTGTGTGTAGGGTGCACAC -> CTGTGTGTAGGGTGCACACT
TGCCAGCCTAATCCCATTAA -> GCCAGCCTAATCCCATTAAT
TTTAACTCACGAGCGGTATT -> TTAACTCACGAGCGGTATTA
TAGGATCAGCTTAGATATCT -> AGGATCAGCTTAGATATCTT
GCACTAAATGATTTTGATAT -> CACTAAATGATTTTGATATG
AATGATTTTGATATGAACCG -> ATGATTTTGATATGAACCGA
AGGTCGCACTAAATGATTTT -> GGTCGCACTAAATGATTTTG
GTAAATTTATAACTGACCGG -> TAAATTTATAACTGACCGGA
GCTACCCTAACTTTCGATTT -> CTACCCTAACTTTCGATTTA
CCACTATGGGACTGCTGGTG -> CACTATGGGACTGCTGGTGC
CCGTTCGTATAAAGAGCCCA -> CGTTCGTATAAAGAGCCCAC
GTCTAATCTTAGAGCGATGG -> TCTAATCTTAGAGCGATGGA
GTCCCCTCGTATTCGAGGTA -> TCCCCTCGTATTCGAGGTAC
GTTCGTATAAAGAGCCCACT -> TTCGTATAAAGAGCCCACTT
TACCCGAGGCGTCCCGAATA -> ACCCGAGGCGTCCCGAATAC
CGTATAAAGAGCCCACTTCA -> GTATAAAGAGCCCACTTCAT
GTCTGTGTGTAGGGTGCACA -> TCTGTGTGTAGGGTGCACAC
TGTCAGGCGCTACGGAGTTT -> GTCAGGCGCTACGGAGTTTT
TGTCGCTCTTATTCGGTATC -> GTCGCTCTTATTCGGTATCA
AACCATAGTAACGGTGACGC -> ACCATAGTAACGGTGACGCC
GTATTATAATTCACGTTTAC -> TATTATAATTCACGTTTACC
TCGGACCGGCCTGTTTCCGG -> CGGACCGGCCTGTTTCCGGC
GCCTGTCGACAATGTGCTGA -> CCTGTCGACAATGTGCTGAT
GTAAACGGTTAGGATCAGCT -> TAAACGGTTAGGATCAGCTT
TGCCTGTCGACAATGTGCTG -> GCCTGTCGACAATGTGCTGA
GGAGCGCGGCTCTGACTCTC -> GAGCGCGGCTCTGACTCTCG
AGTGCCAGCCTAATCCCATT -> GTGCCAGCCTAATCCCATTA
GCGGCTCTGACTCTCGGAAG -> CGGCTCTGACTCTCGGAAGT
TCTGACTCTCGGAAGTCGTT -> CTGACTCTCGGAAGTCGTTT
CTTAACTACGTGTCGAGACA -> TTAACTACGTGTCGAGACAC
TAGACTTTTGCTACGCACAT -> AGACTTTTGCTACGCACATC
GGCGCTACGGAGTTTTTCAT -> GCGCTACGGAGTTTTTCATC
GGATCAGCTTAGATATCTTA -> GATCAGCTTAGATATCTTAG
ATCCCATTAATTAACAATTC -> TCCCATTAATTAACAATTCG
ACCCGAGGCGTCCCGAATAC -> CCCGAGGCGTCCCGAATACT
GAGCCGTCATGGCTTCAGTG -> AGCCGTCATGGCTTCAGTGA
TGAGATCATCCAAGCTCTGT -> GAGATCATCCAAGCTCTGTA
TACAGACTCATAAATACCGT -> ACAGACTCATAAATACCGTT
ACATCCAGGGCTAACCATAG -> CATCCAGGGCTAACCATAGT
GTGGAGCGCGGCTCTGACTC -> TGGAGCGCGGCTCTGACTCT
ATTCTCCCTTATTTACAATG -> TTCTCCCTTATTTACAATGT
ATAACTGTCGGGGCATATCC -> TAACTGTCGGGGCATATCCT
CGAATACTCGGACCGGCCTG -> GAATACTCGGACCGGCCTGT
GATGCGACACGTAATAACTG -> ATGCGACACGTAATAACTGT
CCAAGCTCTGTAAATGGTTG -> CAAGCTCTGTAAATGGTTGT
TAATCATGTCCCCTCGTATT -> AATCATGTCCCCTCGTATTC
GAGCCCACTTCATTCTCCCT -> AGCCCACTTCATTCTCCCTT
GTTGCTTGGTTTGTCGCTCT -> TTGCTTGGTTTGTCGCTCTT
ATCTCGTTGCCGGTGGAGAT -> TCTCGTTGCCGGTGGAGATG
TCACGTTTACCGTAAACGGT -> CACGTTTACCGTAAACGGTT
CCCATTAATTAACAATTCGC -> CCATTAATTAACAATTCGCT
GTGCCAGCCTAATCCCATTA -> TGCCAGCCTAATCCCATTAA
AGTGTAAGAGCAAATTATTT -> GTGTAAGAGCAAATTATTTT
ATGGGACTGCTGGTGCAAAT -> TGGGACTGCTGGTGCAAATA
TACTAGAGGTCGCACTAAAT -> ACTAGAGGTCGCACTAAATG
ATCAAACAGATTACAGACTC -> TCAAACAGATTACAGACTCA
AAAGTAAATTTATAACTGAC -> AAGTAAATTTATAACTGACC
GACCCCGGTGAGATCATCCA -> ACCCCGGTGAGATCATCCAA
TCACTTAGTCTGTGTGTAGG -> CACTTAGTCTGTGTGTAGGG
TCGAACCACTATGGGACTGC -> CGAACCACTATGGGACTGCT
ATTTTCCGGCTGTCTGTGCC -> TTTTCCGGCTGTCTGTGCCT
TGTAGCCCTTAGTTTCCTCT -> GTAGCCCTTAGTTTCCTCTA
GTAGGGTGCACACTTCGTGT -> TAGGGTGCACACTTCGTGTG
GGTATTATAATTCACGTTTA -> GTATTATAATTCACGTTTAC
AACTCACGAGCGGTATTATA -> ACTCACGAGCGGTATTATAA
ACTATGGGACTGCTGGTGCA -> CTATGGGACTGCTGGTGCAA
ATGTAGCCCTTAGTTTCCTC -> TGTAGCCCTTAGTTTCCTCT
CTATTAGTGAATACGCTAGG -> TATTAGTGAATACGCTAGGG
CGGTATCAAACAGATTACAG -> GGTATCAAACAGATTACAGA
CCATTAATTAACAATTCGCT -> CATTAATTAACAATTCGCTT
AAGAGCCCACTTCATTCTCC -> AGAGCCCACTTCATTCTCCC
CCCTGCTCCCTTCGCGCACC -> CCTGCTCCCTTCGCGCACCT
TATTTAACTCACGAGCGGTA -> ATTTAACTCACGAGCGGTAT
TGGAGATGCGACACGTAATA -> GGAGATGCGACACGTAATAA
GTATCAAACAGATTACAGAC -> TATCAAACAGATTACAGACT
GCTGGTGCAAATAACTGTCG -> CTGGTGCAAATAACTGTCGG
GTCGACAATGTGCTGATCTC -> TCGACAATGTGCTGATCTCA
TACGCCCTGCTCCCTTCGCG -> ACGCCCTGCTCCCTTCGCGC
AGCTTAGATATCTTAGGAGC -> GCTTAGATATCTTAGGAGCC
ACGTGTCGAGACACAGTGGT -> CGTGTCGAGACACAGTGGTG
AATCTTAGAGCGATGGAGGG -> ATCTTAGAGCGATGGAGGGT
ACCGAAAGTAAATTTATAAC -> CCGAAAGTAAATTTATAACT
AATAACTGTCGGGGCATATC -> ATAACTGTCGGGGCATATCC
TCTAACGACTTAACTACGTG -> CTAACGACTTAACTACGTGT
CATATCCTAGACTTTTGCTA -> ATATCCTAGACTTTTGCTAC
AGCCTAATCCCATTAATTAA -> GCCTAATCCCATTAATTAAC
ATTACGTAAACATCTGTCGT -> TTACGTAAACATCTGTCGTC
TCATGCCCCGAGAATTACGT -> CATGCCCCGAGAATTACGTA
CAATTGTTGCTTGGTTTGTC -> AATTGTTGCTTGGTTTGTCG
TCTGTCGTCGTAGCGACAAT -> CTGTCGTCGTAGCGACAATT
TGTCGTCGTAGCGACAATTG -> GTCGTCGTAGCGACAATTGT
TACTTAATCATGTCCCCTCG -> ACTTAATCATGTCCCCTCGT
ATCATGTCCCCTCGTATTCG -> TCATGTCCCCTCGTATTCGA
GTCCCGAATACTCGGACCGG -> TCCCGAATACTCGGACCGGC
ATCTGTCGTCGTAGCGACAA -> TCTGTCGTCGTAGCGACAAT
TTAGATATCTTAGGAGCCGT -> TAGATATCTTAGGAGCCGTC
CTATATTCTTAGTGTAAGAG -> TATATTCTTAGTGTAAGAGC
ACAGATTACAGACTCATAAA -> CAGATTACAGACTCATAAAT
CGGGGCATATCCTAGACTTT -> GGGGCATATCCTAGACTTTT
GATCTCACTTAGTCTGTGTG -> ATCTCACTTAGTCTGTGTGT
TCATTCTCCCTTATTTACAA -> CATTCTCCCTTATTTACAAT
AAGTCGTTTAGGACCCCGGT -> AGTCGTTTAGGACCCCGGTG
CAGGGCTAACCATAGTAACG -> AGGGCTAACCATAGTAACGG
CGAGAATTACGTAAACATCT -> GAGAATTACGTAAACATCTG
AATGTAGCCCTTAGTTTCCT -> ATGTAGCCCTTAGTTTCCTC
TTCGCTTACTAGAGGTCGCA -> TCGCTTACTAGAGGTCGCAC
TAGCACAGAAAGTGCCAGCC -> AGCACAGAAAGTGCCAGCCT
ATTATAATTCACGTTTACCG -> TTATAATTCACGTTTACCGT
CGTTCGTATAAAGAGCCCAC -> GTTCGTATAAAGAGCCCACT
AGCGCGGCTCTGACTCTCGG -> GCGCGGCTCTGACTCTCGGA
CAAATTATTTTCCGGCTGTC -> AAATTATTTTCCGGCTGTCT
CGCACATCCAGGGCTAACCA -> GCACATCCAGGGCTAACCAT
GGTTTGTCGCTCTTATTCGG -> GTTTGTCGCTCTTATTCGGT
GGGACTGCTGGTGCAAATAA -> GGACTGCTGGTGCAAATAAC
TAATTCACGTTTACCGTAAA -> AATTCACGTTTACCGTAAAC
TTTACCTTAGCACAGAAAGT -> TTACCTTAGCACAGAAAGTG
CTAACGACTTAACTACGTGT -> TAACGACTTAACTACGTGTC
TGTGGAGCGCGGCTCTGACT -> GTGGAGCGCGGCTCTGACTC
AGTAAATTTATAACTGACCG -> GTAAATTTATAACTGACCGG
GTAGCGACAATTGTTGCTTG -> TAGCGACAATTGTTGCTTGG
AACGGTTAGGATCAGCTTAG -> ACGGTTAGGATCAGCTTAGA
GGCGGGTGCGCACCTATCTA -> GCGGGTGCGCACCTATCTAT
GACGTATGCGCCGTGTACGC -> ACGTATGCGCCGTGTACGCC
CGCTCTTATTCGGTATCAAA -> GCTCTTATTCGGTATCAAAC
GGTGACGCCCTTAAGTACTC -> GTGACGCCCTTAAGTACTCA
GTATAAAGAGCCCACTTCAT -> TATAAAGAGCCCACTTCATT
TATTAGTGAATACGCTAGGG -> ATTAGTGAATACGCTAGGGT
TTAACTCACGAGCGGTATTA -> TAACTCACGAGCGGTATTAT
CACTATGGGACTGCTGGTGC -> ACTATGGGACTGCTGGTGCA
TTACCGTAAACGGTTAGGAT -> TACCGTAAACGGTTAGGATC
GGAAGTCGTTTAGGACCCCG -> GAAGTCGTTTAGGACCCCGG
TCTGTGCCTGTCGACAATGT -> CTGTGCCTGTCGACAATGTG
AACAATTCGCTTACTAGAGG -> ACAATTCGCTTACTAGAGGT
TTTGCTACGCACATCCAGGG -> TTGCTACGCACATCCAGGGC
CCGAGGCGTCCCGAATACTC -> CGAGGCGTCCCGAATACTCG
ACTTAACTACGTGTCGAGAC -> CTTAACTACGTGTCGAGACA
CTCTATTAGTGAATACGCTA -> TCTATTAGTGAATACGCTAG
CTGTCGGGGCATATCCTAGA -> TGTCGGGGCATATCCTAGAC
ATGGTTGTTCGGAGGGGCGG -> TGGTTGTTCGGAGGGGCGGG
TGCTGGGGTACTTAATCATG -> GCTGGGGTACTTAATCATGT
GGGTCGAACCACTATGGGAC -> GGTCGAACCACTATGGGACT
CGCTACGGAGTTTTTCATCT -> GCTACGGAGTTTTTCATCTC
CTTACTAGAGGTCGCACTAA -> TTACTAGAGGTCGCACTAAA
GACAATGTGCTGATCTCACT -> ACAATGTGCTGATCTCACTT
ATCTATTTAACTCACGAGCG -> TCTATTTAACTCACGAGCGG
CGGATCGACGTATGCGCCGT -> GGATCGACGTATGCGCCGTG
GGGTGCACACTTCGTGTGGA -> GGTGCACACTTCGTGTGGAG
CTTCATTCTCCCTTATTTAC -> TTCATTCTCCCTTATTTACA
TCATCCAAGCTCTGTAAATG -> CATCCAAGCTCTGTAAATGG
CAAATAACTGTCGGGGCATA -> AAATAACTGTCGGGGCATAT
TCGCTTACTAGAGGTCGCAC -> CGCTTACTAGAGGTCGCACT
TGTACTAGCTACCCTAACTT -> GTACTAGCTACCCTAACTTT
CCTTAGTTTCCTCTATTAGT -> CTTAGTTTCCTCTATTAGTG
TAAACATCTGTCGTCGTAGC -> AAACATCTGTCGTCGTAGCG
GTAATAACTGTTGAGTCTAA -> TAATAACTGTTGAGTCTAAT
ACTCATGCCCCGAGAATTAC -> CTCATGCCCCGAGAATTACG
GCACCTATCTATTTAACTCA -> CACCTATCTATTTAACTCAC
TGGGGTACTTAATCATGTCC -> GGGGTACTTAATCATGTCCC
GATGCTGGGGTACTTAATCA -> ATGCTGGGGTACTTAATCAT
GTGCCTGTCGACAATGTGCT -> TGCCTGTCGACAATGTGCTG
GATGGAGGGTCGAACCACTA -> ATGGAGGGTCGAACCACTAT
TCAGTGATGCTGGGGTACTT -> CAGTGATGCTGGGGTACTTA
TGTGTGTAGGGTGCACACTT -> GTGTGTAGGGTGCACACTTC
TGTTCGGAGGGGCGGGTGCG -> GTTCGGAGGGGCGGGTGCGC
GTCGTCGTAGCGACAATTGT -> TCGTCGTAGCGACAATTGTT
GTCGTTTAGGACCCCGGTGA -> TCGTTTAGGACCCCGGTGAG
TAGTAACGGTGACGCCCTTA -> AGTAACGGTGACGCCCTTAA
TCGGAAGTCGTTTAGGACCC -> CGGAAGTCGTTTAGGACCCC
TAGCGACAATTGTTGCTTGG -> AGCGACAATTGTTGCTTGGT
GGTGCGCACCTATCTATTTA -> GTGCGCACCTATCTATTTAA
TGTAAATGGTTGTTCGGAGG -> GTAAATGGTTGTTCGGAGGG
ACATCTGTCGTCGTAGCGAC -> CATCTGTCGTCGTAGCGACA
CGTCCCGAATACTCGGACCG -> GTCCCGAATACTCGGACCGG
TCAAACAGATTACAGACTCA -> CAAACAGATTACAGACTCAT
AAGTAAATTTATAACTGACC -> AGTAAATTTATAACTGACCG
ATACGCTAGGGTCTAACGAC -> TACGCTAGGGTCTAACGACT
GGAGTTTTTCATCTCGTTGC -> GAGTTTTTCATCTCGTTGCC
CCCGAATACTCGGACCGGCC -> CCGAATACTCGGACCGGCCT
AGCGGTATTATAATTCACGT -> GCGGTATTATAATTCACGTT
TCAGCTTAGATATCTTAGGA -> CAGCTTAGATATCTTAGGAG
TTACAGACTCATAAATACCG -> TACAGACTCATAAATACCGT
ATTTACCTTAGCACAGAAAG -> TTTACCTTAGCACAGAAAGT
TACCCTAACTTTCGATTTAC -> ACCCTAACTTTCGATTTACC
TCGTTTAGGACCCCGGTGAG -> CGTTTAGGACCCCGGTGAGA
ACGTATGCGCCGTGTACGCC -> CGTATGCGCCGTGTACGCCC
TTAGGAGCCGTCATGGCTTC -> TAGGAGCCGTCATGGCTTCA
AGACTTTTGCTACGCACATC -> GACTTTTGCTACGCACATCC
AGTGAATACGCTAGGGTCTA -> GTGAATACGCTAGGGTCTAA
TTGATATGAACCGAAAGTAA -> TGATATGAACCGAAAGTAAA
TATTCGGTATCAAACAGATT -> ATTCGGTATCAAACAGATTA
GCTCTGTAAATGGTTGTTCG -> CTCTGTAAATGGTTGTTCGG
GAGGGTCGAACCACTATGGG -> AGGGTCGAACCACTATGGGA
TAAACGGTTAGGATCAGCTT -> AAACGGTTAGGATCAGCTTA
CGGCTGTCTGTGCCTGTCGA -> GGCTGTCTGTGCCTGTCGAC
TTAGGATCAGCTTAGATATC -> TAGGATCAGCTTAGATATCT
TAACTACGTGTCGAGACACA -> AACTACGTGTCGAGACACAG
GGTGCAAATAACTGTCGGGG -> GTGCAAATAACTGTCGGGGC
GGTCGCACTAAATGATTTTG -> GTCGCACTAAATGATTTTGA
TTTACCGTAAACGGTTAGGA -> TTACCGTAAACGGTTAGGAT
TCTATTAGTGAATACGCTAG -> CTATTAGTGAATACGCTAGG
ATTAACAATTCGCTTACTAG -> TTAACAATTCGCTTACTAGA
ACCTGTACTAGCTACCCTAA -> CCTGTACTAGCTACCCTAAC
CGTTTAGGACCCCGGTGAGA -> GTTTAGGACCCCGGTGAGAT
CATCTCGTTGCCGGTGGAGA -> ATCTCGTTGCCGGTGGAGAT
GTGTTAGAATACAAATCAGT -> TGTTAGAATACAAATCAGTA
AGACACAGTGGTGATCGGAT -> GACACAGTGGTGATCGGATC
TGATGCTGGGGTACTTAATC -> GATGCTGGGGTACTTAATCA
ACGTTTACCGTAAACGGTTA -> CGTTTACCGTAAACGGTTAG
GCTACGGAGTTTTTCATCTC -> CTACGGAGTTTTTCATCTCG
CCTCTATTAGTGAATACGCT -> CTCTATTAGTGAATACGCTA
GAGGTCGCACTAAATGATTT -> AGGTCGCACTAAATGATTTT
ATCCTAGACTTTTGCTACGC -> TCCTAGACTTTTGCTACGCA
GAAAGTGCCAGCCTAATCCC -> AAAGTGCCAGCCTAATCCCA
CCTATCTATTTAACTCACGA -> CTATCTATTTAACTCACGAG
TGGTGATCGGATCGACGTAT -> GGTGATCGGATCGACGTATG
TATAAAGAGCCCACTTCATT -> ATAAAGAGCCCACTTCATTC
TAACGGTGACGCCCTTAAGT -> AACGGTGACGCCCTTAAGTA
AGAGCAAATTATTTTCCGGC -> GAGCAAATTATTTTCCGGCT
CTGTCGTCGTAGCGACAATT -> TGTCGTCGTAGCGACAATTG
ATCCAGGGCTAACCATAGTA -> TCCAGGGCTAACCATAGTAA
AAGAGCAAATTATTTTCCGG -> AGAGCAAATTATTTTCCGGC
GTCTTTGTGTTAGAATACAA -> TCTTTGTGTTAGAATACAAA
GGCGTCCCGAATACTCGGAC -> GCGTCCCGAATACTCGGACC
TCGAGGTACCCGAGGCGTCC -> CGAGGTACCCGAGGCGTCCC
GTGATGCTGGGGTACTTAAT -> TGATGCTGGGGTACTTAATC
TGCTGATCTCACTTAGTCTG -> GCTGATCTCACTTAGTCTGT
CTATCTATTTAACTCACGAG -> TATCTATTTAACTCACGAGC
GCCTAATCCCATTAATTAAC -> CCTAATCCCATTAATTAACA
AGTAACGGTGACGCCCTTAA -> GTAACGGTGACGCCCTTAAG
GAACCGAAAGTAAATTTATA -> AACCGAAAGTAAATTTATAA
CTGTACTAGCTACCCTAACT -> TGTACTAGCTACCCTAACTT
AACTTTCGATTTACCTTAGC -> ACTTTCGATTTACCTTAGCA
AGCTACCCTAACTTTCGATT -> GCTACCCTAACTTTCGATTT
CTTAATCATGTCCCCTCGTA -> TTAATCATGTCCCCTCGTAT
TAGAATACAAATCAGTACTA -> AGAATACAAATCAGTACTAT
ATGTGCTGATCTCACTTAGT -> TGTGCTGATCTCACTTAGTC
CGGACCGGCCTGTTTCCGGC -> GGACCGGCCTGTTTCCGGCT
ACGCCCTGCTCCCTTCGCGC -> CGCCCTGCTCCCTTCGCGCA
AGGGTCGAACCACTATGGGA -> GGGTCGAACCACTATGGGAC
AGTGGTGATCGGATCGACGT -> GTGGTGATCGGATCGACGTA
TACAATGTAGCCCTTAGTTT -> ACAATGTAGCCCTTAGTTTC
TGTGTAGGGTGCACACTTCG -> GTGTAGGGTGCACACTTCGT
ACTATATTCTTAGTGTAAGA -> CTATATTCTTAGTGTAAGAG
CTGCTCCCTTCGCGCACCTG -> TGCTCCCTTCGCGCACCTGT
GTGACGCCCTTAAGTACTCA -> TGACGCCCTTAAGTACTCAT
AAATAACTGTCGGGGCATAT -> AATAACTGTCGGGGCATATC
CGACAATTGTTGCTTGGTTT -> GACAATTGTTGCTTGGTTTG
TTTGATATGAACCGAAAGTA -> TTGATATGAACCGAAAGTAA
ATTTTGATATGAACCGAAAG -> TTTTGATATGAACCGAAAGT
AACCACTATGGGACTGCTGG -> ACCACTATGGGACTGCTGGT
GCCCTTAGTTTCCTCTATTA -> CCCTTAGTTTCCTCTATTAG
AAATGGTTGTTCGGAGGGGC -> AATGGTTGTTCGGAGGGGCG
CTTTTGCTACGCACATCCAG -> TTTTGCTACGCACATCCAGG
TGAACCGAAAGTAAATTTAT -> GAACCGAAAGTAAATTTATA
TAACTGTCGGGGCATATCCT -> AACTGTCGGGGCATATCCTA
TCGAGACACAGTGGTGATCG -> CGAGACACAGTGGTGATCGG
GCCCTTAAGTACTCATGCCC -> CCCTTAAGTACTCATGCCCC
ACTGTTGAGTCTAATCTTAG -> CTGTTGAGTCTAATCTTAGA
TATAATTCACGTTTACCGTA -> ATAATTCACGTTTACCGTAA
TTTCATCTCGTTGCCGGTGG -> TTCATCTCGTTGCCGGTGGA
TATCTATTTAACTCACGAGC -> ATCTATTTAACTCACGAGCG
TCTTAGGAGCCGTCATGGCT -> CTTAGGAGCCGTCATGGCTT
TTAATCATGTCCCCTCGTAT -> TAATCATGTCCCCTCGTATT
TGATATGAACCGAAAGTAAA -> GATATGAACCGAAAGTAAAT
TTAGGACCCCGGTGAGATCA -> TAGGACCCCGGTGAGATCAT
CACATCCAGGGCTAACCATA -> ACATCCAGGGCTAACCATAG
TTCGTATAAAGAGCCCACTT -> TCGTATAAAGAGCCCACTTC
GCATATCCTAGACTTTTGCT -> CATATCCTAGACTTTTGCTA
GCTGGGGTACTTAATCATGT -> CTGGGGTACTTAATCATGTC
TCAGGCGCTACGGAGTTTTT -> CAGGCGCTACGGAGTTTTTC
TTTCGATTTACCTTAGCACA -> TTCGATTTACCTTAGCACAG
CGGTGAGATCATCCAAGCTC -> GGTGAGATCATCCAAGCTCT
TGGTTGTTCGGAGGGGCGGG -> GGTTGTTCGGAGGGGCGGGT
ACGTAAACATCTGTCGTCGT -> CGTAAACATCTGTCGTCGTA
GCCCTGCTCCCTTCGCGCAC -> CCCTGCTCCCTTCGCGCACC
CGTCATGGCTTCAGTGATGC -> GTCATGGCTTCAGTGATGCT
ATTCTTAGTGTAAGAGCAAA -> TTCTTAGTGTAAGAGCAAAT
TCGTGTGGAGCGCGGCTCTG -> CGTGTGGAGCGCGGCTCTGA
TTGGTTTGTCGCTCTTATTC -> TGGTTTGTCGCTCTTATTCG
GACCCGTCTTTGTGTTAGAA -> ACCCGTCTTTGTGTTAGAAT
GTTTGTCGCTCTTATTCGGT -> TTTGTCGCTCTTATTCGGTA
TCACGAGCGGTATTATAATT -> CACGAGCGGTATTATAATTC
GTCTAACGACTTAACTACGT -> TCTAACGACTTAACTACGTG
TAGTGAATACGCTAGGGTCT -> AGTGAATACGCTAGGGTCTA
GTTAGGATCAGCTTAGATAT -> TTAGGATCAGCTTAGATATC
ATAGTAACGGTGACGCCCTT -> TAGTAACGGTGACGCCCTTA
AGGGTGCACACTTCGTGTGG -> GGGTGCACACTTCGTGTGGA
CAGATTACAGACTCATAAAT -> AGATTACAGACTCATAAATA
GCCAGCCTAATCCCATTAAT -> CCAGCCTAATCCCATTAATT
ACGCTAGGGTCTAACGACTT -> CGCTAGGGTCTAACGACTTA
TGCTCCCTTCGCGCACCTGT -> GCTCCCTTCGCGCACCTGTA
CGAACCACTATGGGACTGCT -> GAACCACTATGGGACTGCTG
CTAACTTTCGATTTACCTTA -> TAACTTTCGATTTACCTTAG
GCGGTATTATAATTCACGTT -> CGGTATTATAATTCACGTTT
TCGTAGCGACAATTGTTGCT -> CGTAGCGACAATTGTTGCTT
TTCGATTTACCTTAGCACAG -> TCGATTTACCTTAGCACAGA
GATCAGCTTAGATATCTTAG -> ATCAGCTTAGATATCTTAGG
TAGGGTGCACACTTCGTGTG -> AGGGTGCACACTTCGTGTGG
GTCGCTCTTATTCGGTATCA -> TCGCTCTTATTCGGTATCAA
GTGTACGCCCTGCTCCCTTC -> TGTACGCCCTGCTCCCTTCG
CACTTAGTCTGTGTGTAGGG -> ACTTAGTCTGTGTGTAGGGT
CATGTCCCCTCGTATTCGAG -> ATGTCCCCTCGTATTCGAGG
TATTTACAATGTAGCCCTTA -> ATTTACAATGTAGCCCTTAG
TATCTTAGGAGCCGTCATGG -> ATCTTAGGAGCCGTCATGGC
AAATACCGTTCGTATAAAGA -> AATACCGTTCGTATAAAGAG
TAACCATAGTAACGGTGACG -> AACCATAGTAACGGTGACGC
TCCGGCTGTCTGTGCCTGTC -> CCGGCTGTCTGTGCCTGTCG
ACCGGCCTGTTTCCGGCTAA -> CCGGCCTGTTTCCGGCTAAC
CCCCTCGTATTCGAGGTACC -> CCCTCGTATTCGAGGTACCC
TTGCTTGGTTTGTCGCTCTT -> TGCTTGGTTTGTCGCTCTTA
TCCCATTAATTAACAATTCG -> CCCATTAATTAACAATTCGC
TGTCTGTGCCTGTCGACAAT -> GTCTGTGCCTGTCGACAATG
CGGAGGGGCGGGTGCGCACC -> GGAGGGGCGGGTGCGCACCT
TTAATTAACAATTCGCTTAC -> TAATTAACAATTCGCTTACT
TAACTTTCGATTTACCTTAG -> AACTTTCGATTTACCTTAGC
TTAACAATTCGCTTACTAGA -> TAACAATTCGCTTACTAGAG
TCGTATTCGAGGTACCCGAG -> CGTATTCGAGGTACCCGAGG
AGAATACAAATCAGTACTAT -> GAATACAAATCAGTACTATA
CACGTTTACCGTAAACGGTT -> ACGTTTACCGTAAACGGTTA
ACTTAATCATGTCCCCTCGT -> CTTAATCATGTCCCCTCGTA
CTGTAAATGGTTGTTCGGAG -> TGTAAATGGTTGTTCGGAGG
CTGGGGTACTTAATCATGTC -> TGGGGTACTTAATCATGTCC
TGCTGGTGCAAATAACTGTC -> GCTGGTGCAAATAACTGTCG
AGGCGTCCCGAATACTCGGA -> GGCGTCCCGAATACTCGGAC
GTCGGGGCATATCCTAGACT -> TCGGGGCATATCCTAGACTT
AGCCCACTTCATTCTCCCTT -> GCCCACTTCATTCTCCCTTA
TCTAATCTTAGAGCGATGGA -> CTAATCTTAGAGCGATGGAG
TATATTCTTAGTGTAAGAGC -> ATATTCTTAGTGTAAGAGCA
ATATCCTAGACTTTTGCTAC -> TATCCTAGACTTTTGCTACG
TGAATACGCTAGGGTCTAAC -> GAATACGCTAGGGTCTAACG
ACCGTTCGTATAAAGAGCCC -> CCGTTCGTATAAAGAGCCCA
ATTGTTGCTTGGTTTGTCGC -> TTGTTGCTTGGTTTGTCGCT
CCACTTCATTCTCCCTTATT -> CACTTCATTCTCCCTTATTT
GCAAATTATTTTCCGGCTGT -> CAAATTATTTTCCGGCTGTC
CTTATTCGGTATCAAACAGA -> TTATTCGGTATCAAACAGAT
TAAATGGTTGTTCGGAGGGG -> AAATGGTTGTTCGGAGGGGC
AGCGACAATTGTTGCTTGGT -> GCGACAATTGTTGCTTGGTT
CATGGCTTCAGTGATGCTGG -> ATGGCTTCAGTGATGCTGGG
ATAAATACCGTTCGTATAAA -> TAAATACCGTTCGTATAAAG
CCTCGTATTCGAGGTACCCG -> CTCGTATTCGAGGTACCCGA
CTACCCTAACTTTCGATTTA -> TACCCTAACTTTCGATTTAC
ACACAGTGGTGATCGGATCG -> CACAGTGGTGATCGGATCGA
ATACTCGGACCGGCCTGTTT -> TACTCGGACCGGCCTGTTTC
GAGCAAATTATTTTCCGGCT -> AGCAAATTATTTTCCGGCTG
ATGATTTTGATATGAACCGA -> TGATTTTGATATGAACCGAA
CAATGTGCTGATCTCACTTA -> AATGTGCTGATCTCACTTAG
GCGCTACGGAGTTTTTCATC -> CGCTACGGAGTTTTTCATCT
ACTAAATGATTTTGATATGA -> CTAAATGATTTTGATATGAA
CCCTTAGTTTCCTCTATTAG -> CCTTAGTTTCCTCTATTAGT
ATTACAGACTCATAAATACC -> TTACAGACTCATAAATACCG
ACCATAGTAACGGTGACGCC -> CCATAGTAACGGTGACGCCC
ACACGTAATAACTGTTGAGT -> CACGTAATAACTGTTGAGTC
GCTACGCACATCCAGGGCTA -> CTACGCACATCCAGGGCTAA
GTACTAGCTACCCTAACTTT -> TACTAGCTACCCTAACTTTC
CGTTGCCGGTGGAGATGCGA -> GTTGCCGGTGGAGATGCGAC
CGTCTTTGTGTTAGAATACA -> GTCTTTGTGTTAGAATACAA
CGCCCTGCTCCCTTCGCGCA -> GCCCTGCTCCCTTCGCGCAC
TGTAGGGTGCACACTTCGTG -> GTAGGGTGCACACTTCGTGT
TTTTCCGGCTGTCTGTGCCT -> TTTCCGGCTGTCTGTGCCTG
AATCCCATTAATTAACAATT -> ATCCCATTAATTAACAATTC
GTGTAAGAGCAAATTATTTT -> TGTAAGAGCAAATTATTTTC
CCTAGACTTTTGCTACGCAC -> CTAGACTTTTGCTACGCACA
ATCAGTACTATATTCTTAGT -> TCAGTACTATATTCTTAGTG
GCTCCCTTCGCGCACCTGTA -> CTCCCTTCGCGCACCTGTAC
ACAGAAAGTGCCAGCCTAAT -> CAGAAAGTGCCAGCCTAATC
ATGCGCCGTGTACGCCCTGC -> TGCGCCGTGTACGCCCTGCT
TGGTGCAAATAACTGTCGGG -> GGTGCAAATAACTGTCGGGG
GTGGTGATCGGATCGACGTA -> TGGTGATCGGATCGACGTAT
TCCCTTATTTACAATGTAGC -> CCCTTATTTACAATGTAGCC
CCTTAAGTACTCATGCCCCG -> CTTAAGTACTCATGCCCCGA
ATGGAGGGTCGAACCACTAT -> TGGAGGGTCGAACCACTATG
TTTTGATATGAACCGAAAGT -> TTTGATATGAACCGAAAGTA
GTCGAGACACAGTGGTGATC -> TCGAGACACAGTGGTGATCG
AGAGCCCACTTCATTCTCCC -> GAGCCCACTTCATTCTCCCT
CGCACCTATCTATTTAACTC -> GCACCTATCTATTTAACTCA
CACAGTGGTGATCGGATCGA -> ACAGTGGTGATCGGATCGAC
CGCGCACCTGTACTAGCTAC -> GCGCACCTGTACTAGCTACC
CGATGGAGGGTCGAACCACT -> GATGGAGGGTCGAACCACTA
CGCACTAAATGATTTTGATA -> GCACTAAATGATTTTGATAT
ACTGCTGGTGCAAATAACTG -> CTGCTGGTGCAAATAACTGT
GATTACAGACTCATAAATAC -> ATTACAGACTCATAAATACC
TTAGTGTAAGAGCAAATTAT -> TAGTGTAAGAGCAAATTATT
TAACTGTTGAGTCTAATCTT -> AACTGTTGAGTCTAATCTTA
CTCGGACCGGCCTGTTTCCG -> TCGGACCGGCCTGTTTCCGG
TAGCCCTTAGTTTCCTCTAT -> AGCCCTTAGTTTCCTCTATT
CCCTTAAGTACTCATGCCCC -> CCTTAAGTACTCATGCCCCG
CCTGTACTAGCTACCCTAAC -> CTGTACTAGCTACCCTAACT
CGTTTACCGTAAACGGTTAG -> GTTTACCGTAAACGGTTAGG
TGGCTTCAGTGATGCTGGGG -> GGCTTCAGTGATGCTGGGGT
TTATAATTCACGTTTACCGT -> TATAATTCACGTTTACCGTA
TTTGTCGCTCTTATTCGGTA -> TTGTCGCTCTTATTCGGTAT
AACCGAAAGTAAATTTATAA -> ACCGAAAGTAAATTTATAAC
TAAATGATTTTGATATGAAC -> AAATGATTTTGATATGAACC
ACAGACTCATAAATACCGTT -> CAGACTCATAAATACCGTTC
AGTTTCCTCTATTAGTGAAT -> GTTTCCTCTATTAGTGAATA
ATCCAAGCTCTGTAAATGGT -> TCCAAGCTCTGTAAATGGTT
TAAGTACTCATGCCCCGAGA -> AAGTACTCATGCCCCGAGAA
CAAACAGATTACAGACTCAT -> AAACAGATTACAGACTCATA
ATTATTTTCCGGCTGTCTGT -> TTATTTTCCGGCTGTCTGTG
CGTAGCGACAATTGTTGCTT -> GTAGCGACAATTGTTGCTTG
AGAGGTCGCACTAAATGATT -> GAGGTCGCACTAAATGATTT
GGCTTCAGTGATGCTGGGGT -> GCTTCAGTGATGCTGGGGTA
GGTATCAAACAGATTACAGA -> GTATCAAACAGATTACAGAC
GACTCATAAATACCGTTCGT -> ACTCATAAATACCGTTCGTA
CCAGCCTAATCCCATTAATT -> CAGCCTAATCCCATTAATTA
ACCTTAGCACAGAAAGTGCC -> CCTTAGCACAGAAAGTGCCA
ATACAAATCAGTACTATATT -> TACAAATCAGTACTATATTC
CGACAATGTGCTGATCTCAC -> GACAATGTGCTGATCTCACT
ACGGTTAGGATCAGCTTAGA -> CGGTTAGGATCAGCTTAGAT
ATCTCACTTAGTCTGTGTGT -> TCTCACTTAGTCTGTGTGTA
CGGTGACGCCCTTAAGTACT -> GGTGACGCCCTTAAGTACTC
ATTCGGTATCAAACAGATTA -> TTCGGTATCAAACAGATTAC
ATTCACGTTTACCGTAAACG -> TTCACGTTTACCGTAAACGG
ATAATTCACGTTTACCGTAA -> TAATTCACGTTTACCGTAAA
GAGTTTTTCATCTCGTTGCC -> AGTTTTTCATCTCGTTGCCG
TTAGTTTCCTCTATTAGTGA -> TAGTTTCCTCTATTAGTGAA
TAATCCCATTAATTAACAAT -> AATCCCATTAATTAACAATT
GTAACGGTGACGCCCTTAAG -> TAACGGTGACGCCCTTAAGT
TATGGGACTGCTGGTGCAAA -> ATGGGACTGCTGGTGCAAAT
CCTTAGCACAGAAAGTGCCA -> CTTAGCACAGAAAGTGCCAG
CGCTTACTAGAGGTCGCACT -> GCTTACTAGAGGTCGCACTA
TGTGTTAGAATACAAATCAG -> GTGTTAGAATACAAATCAGT
CGGAAGTCGTTTAGGACCCC -> GGAAGTCGTTTAGGACCCCG
TTTCCTCTATTAGTGAATAC -> TTCCTCTATTAGTGAATACG
CGATTTACCTTAGCACAGAA -> GATTTACCTTAGCACAGAAA
AGCGATGGAGGGTCGAACCA -> GCGATGGAGGGTCGAACCAC
ATTTACAATGTAGCCCTTAG -> TTTACAATGTAGCCCTTAGT
GATATCTTAGGAGCCGTCAT -> ATATCTTAGGAGCCGTCATG
CACTTCGTGTGGAGCGCGGC -> ACTTCGTGTGGAGCGCGGCT
TACGCTAGGGTCTAACGACT -> ACGCTAGGGTCTAACGACTT
TCTTAGAGCGATGGAGGGTC -> CTTAGAGCGATGGAGGGTCG
ATAAAGAGCCCACTTCATTC -> TAAAGAGCCCACTTCATTCT
TAAATACCGTTCGTATAAAG -> AAATACCGTTCGTATAAAGA
GTTTCCTCTATTAGTGAATA -> TTTCCTCTATTAGTGAATAC
TACTCGGACCGGCCTGTTTC -> ACTCGGACCGGCCTGTTTCC
ATTTATAACTGACCGGACCC -> TTTATAACTGACCGGACCCG
CACCTGTACTAGCTACCCTA -> ACCTGTACTAGCTACCCTAA
TGTGCTGATCTCACTTAGTC -> GTGCTGATCTCACTTAGTCT
TCTCACTTAGTCTGTGTGTA -> CTCACTTAGTCTGTGTGTAG
TTCGAGGTACCCGAGGCGTC -> TCGAGGTACCCGAGGCGTCC
CATCCAAGCTCTGTAAATGG -> ATCCAAGCTCTGTAAATGGT
TGTCGGGGCATATCCTAGAC -> GTCGGGGCATATCCTAGACT
GAGCGGTATTATAATTCACG -> AGCGGTATTATAATTCACGT
TCTTTGTGTTAGAATACAAA -> CTTTGTGTTAGAATACAAAT
CTTAGTTTCCTCTATTAGTG -> TTAGTTTCCTCTATTAGTGA
AGGGCTAACCATAGTAACGG -> GGGCTAACCATAGTAACGGT
ATTTAACTCACGAGCGGTAT -> TTTAACTCACGAGCGGTATT
ACGCACATCCAGGGCTAACC -> CGCACATCCAGGGCTAACCA
AGATCATCCAAGCTCTGTAA -> GATCATCCAAGCTCTGTAAA
TCATGTCCCCTCGTATTCGA -> CATGTCCCCTCGTATTCGAG
TGATCTCACTTAGTCTGTGT -> GATCTCACTTAGTCTGTGTG
TAAATTTATAACTGACCGGA -> AAATTTATAACTGACCGGAC
AATACTCGGACCGGCCTGTT -> ATACTCGGACCGGCCTGTTT
CTCCCTTCGCGCACCTGTAC -> TCCCTTCGCGCACCTGTACT
TCTATTTAACTCACGAGCGG -> CTATTTAACTCACGAGCGGT
AATTCACGTTTACCGTAAAC -> ATTCACGTTTACCGTAAACG
CTTAGTCTGTGTGTAGGGTG -> TTAGTCTGTGTGTAGGGTGC
TTTTTCATCTCGTTGCCGGT -> TTTTCATCTCGTTGCCGGTG
CACCTATCTATTTAACTCAC -> ACCTATCTATTTAACTCACG
AAACAGATTACAGACTCATA -> AACAGATTACAGACTCATAA
CGGTTAGGATCAGCTTAGAT -> GGTTAGGATCAGCTTAGATA
TTCGTGTGGAGCGCGGCTCT -> TCGTGTGGAGCGCGGCTCTG
CGGCCTGTTTCCGGCTAACA -> GGCCTGTTTCCGGCTAACAT
TAGATATCTTAGGAGCCGTC -> AGATATCTTAGGAGCCGTCA
ACGGTGACGCCCTTAAGTAC -> CGGTGACGCCCTTAAGTACT
CTCATGCCCCGAGAATTACG -> TCATGCCCCGAGAATTACGT
TAGTGTAAGAGCAAATTATT -> AGTGTAAGAGCAAATTATTT
GGAGGGTCGAACCACTATGG -> GAGGGTCGAACCACTATGGG
CGACACGTAATAACTGTTGA -> GACACGTAATAACTGTTGAG
GTACTATATTCTTAGTGTAA -> TACTATATTCTTAGTGTAAG
TCGGATCGACGTATGCGCCG -> CGGATCGACGTATGCGCCGT
GTACTCATGCCCCGAGAATT -> TACTCATGCCCCGAGAATTA
CGACGTATGCGCCGTGTACG -> GACGTATGCGCCGTGTACGC
CTTAGCACAGAAAGTGCCAG -> TTAGCACAGAAAGTGCCAGC
TCTCCCTTATTTACAATGTA -> CTCCCTTATTTACAATGTAG
TATTCTTAGTGTAAGAGCAA -> ATTCTTAGTGTAAGAGCAAA
AATTTATAACTGACCGGACC -> ATTTATAACTGACCGGACCC
GAATACAAATCAGTACTATA -> AATACAAATCAGTACTATAT
GGGCGGGTGCGCACCTATCT -> GGCGGGTGCGCACCTATCTA
TGGTTTGTCGCTCTTATTCG -> GGTTTGTCGCTCTTATTCGG
TTCGGAGGGGCGGGTGCGCA -> TCGGAGGGGCGGGTGCGCAC
TGTAAGAGCAAATTATTTTC -> GTAAGAGCAAATTATTTTCC
TCGACGTATGCGCCGTGTAC -> CGACGTATGCGCCGTGTACG
GGTGGAGATGCGACACGTAA -> GTGGAGATGCGACACGTAAT
ACTTAGTCTGTGTGTAGGGT -> CTTAGTCTGTGTGTAGGGTG
CATAGTAACGGTGACGCCCT -> ATAGTAACGGTGACGCCCTT
GATCGGATCGACGTATGCGC -> ATCGGATCGACGTATGCGCC
TTGAGTCTAATCTTAGAGCG -> TGAGTCTAATCTTAGAGCGA
CTTCGTGTGGAGCGCGGCTC -> TTCGTGTGGAGCGCGGCTCT
CTTGGTTTGTCGCTCTTATT -> TTGGTTTGTCGCTCTTATTC
CTCATAAATACCGTTCGTAT -> TCATAAATACCGTTCGTATA
AGATATCTTAGGAGCCGTCA -> GATATCTTAGGAGCCGTCAT
CAGACTCATAAATACCGTTC -> AGACTCATAAATACCGTTCG
AATCATGTCCCCTCGTATTC -> ATCATGTCCCCTCGTATTCG
CGAGACACAGTGGTGATCGG -> GAGACACAGTGGTGATCGGA
GTTTTTCATCTCGTTGCCGG -> TTTTTCATCTCGTTGCCGGT
GTAGCCCTTAGTTTCCTCTA -> TAGCCCTTAGTTTCCTCTAT
CAAATCAGTACTATATTCTT -> AAATCAGTACTATATTCTTA
TTATTTACAATGTAGCCCTT -> TATTTACAATGTAGCCCTTA
TCGGTATCAAACAGATTACA -> CGGTATCAAACAGATTACAG
CAGTACTATATTCTTAGTGT -> AGTACTATATTCTTAGTGTA
GCGACACGTAATAACTGTTG -> CGACACGTAATAACTGTTGA
TAGTTTCCTCTATTAGTGAA -> AGTTTCCTCTATTAGTGAAT
ATAACTGTTGAGTCTAATCT -> TAACTGTTGAGTCTAATCTT
CCTGCTCCCTTCGCGCACCT -> CTGCTCCCTTCGCGCACCTG
ACTCGGACCGGCCTGTTTCC -> CTCGGACCGGCCTGTTTCCG
AGAGCGATGGAGGGTCGAAC -> GAGCGATGGAGGGTCGAACC
CACACTTCGTGTGGAGCGCG -> ACACTTCGTGTGGAGCGCGG
CCGTGTACGCCCTGCTCCCT -> CGTGTACGCCCTGCTCCCTT
GCCCACTTCATTCTCCCTTA -> CCCACTTCATTCTCCCTTAT
CTATGGGACTGCTGGTGCAA -> TATGGGACTGCTGGTGCAAA
CATCTGTCGTCGTAGCGACA -> ATCTGTCGTCGTAGCGACAA
AAATGATTTTGATATGAACC -> AATGATTTTGATATGAACCG
TAACAATTCGCTTACTAGAG -> AACAATTCGCTTACTAGAGG
GGGGCGGGTGCGCACCTATC -> GGGCGGGTGCGCACCTATCT
CAGTGGTGATCGGATCGACG -> AGTGGTGATCGGATCGACGT
CGCCCTTAAGTACTCATGCC -> GCCCTTAAGTACTCATGCCC
CTGTCTGTGCCTGTCGACAA -> TGTCTGTGCCTGTCGACAAT
AAATTTATAACTGACCGGAC -> AATTTATAACTGACCGGACC
CCCTTATTTACAATGTAGCC -> CCTTATTTACAATGTAGCCC
GAAAGTAAATTTATAACTGA -> AAAGTAAATTTATAACTGAC
GTTGCCGGTGGAGATGCGAC -> TTGCCGGTGGAGATGCGACA
TACGCACATCCAGGGCTAAC -> ACGCACATCCAGGGCTAACC
GTAAATGGTTGTTCGGAGGG -> TAAATGGTTGTTCGGAGGGG
GTCATGGCTTCAGTGATGCT -> TCATGGCTTCAGTGATGCTG
ACAATTCGCTTACTAGAGGT -> CAATTCGCTTACTAGAGGTC
ATTAATTAACAATTCGCTTA -> TTAATTAACAATTCGCTTAC
TTACAATGTAGCCCTTAGTT -> TACAATGTAGCCCTTAGTTT
TCAGTACTATATTCTTAGTG -> CAGTACTATATTCTTAGTGT
AATTCGCTTACTAGAGGTCG -> ATTCGCTTACTAGAGGTCGC
GGTTAGGATCAGCTTAGATA -> GTTAGGATCAGCTTAGATAT
TATGCGCCGTGTACGCCCTG -> ATGCGCCGTGTACGCCCTGC
GTGCAAATAACTGTCGGGGC -> TGCAAATAACTGTCGGGGCA
AATGTGCTGATCTCACTTAG -> ATGTGCTGATCTCACTTAGT
CCCGTCTTTGTGTTAGAATA -> CCGTCTTTGTGTTAGAATAC
AGGGTCTAACGACTTAACTA -> GGGTCTAACGACTTAACTAC
GGTTGTTCGGAGGGGCGGGT -> GTTGTTCGGAGGGGCGGGTG
GAGATCATCCAAGCTCTGTA -> AGATCATCCAAGCTCTGTAA
CTTAGAGCGATGGAGGGTCG -> TTAGAGCGATGGAGGGTCGA
CGGACCCGTCTTTGTGTTAG -> GGACCCGTCTTTGTGTTAGA
TGGGACTGCTGGTGCAAATA -> GGGACTGCTGGTGCAAATAA
AGGTACCCGAGGCGTCCCGA -> GGTACCCGAGGCGTCCCGAA
GTTTACCGTAAACGGTTAGG -> TTTACCGTAAACGGTTAGGA
CAGCTTAGATATCTTAGGAG -> AGCTTAGATATCTTAGGAGC
GCACATCCAGGGCTAACCAT -> CACATCCAGGGCTAACCATA
ACGGAGTTTTTCATCTCGTT -> CGGAGTTTTTCATCTCGTTG
CCTTATTTACAATGTAGCCC -> CTTATTTACAATGTAGCCCT
TACAAATCAGTACTATATTC -> ACAAATCAGTACTATATTCT
TTCATCTCGTTGCCGGTGGA -> TCATCTCGTTGCCGGTGGAG
CTCCCTTATTTACAATGTAG -> TCCCTTATTTACAATGTAGC
CCCTAACTTTCGATTTACCT -> CCTAACTTTCGATTTACCTT
GGCTCTGACTCTCGGAAGTC -> GCTCTGACTCTCGGAAGTCG
ACACTTCGTGTGGAGCGCGG -> CACTTCGTGTGGAGCGCGGC
GGCATATCCTAGACTTTTGC -> GCATATCCTAGACTTTTGCT
TCCAAGCTCTGTAAATGGTT -> CCAAGCTCTGTAAATGGTTG
CTTAGTGTAAGAGCAAATTA -> TTAGTGTAAGAGCAAATTAT
GACGCCCTTAAGTACTCATG -> ACGCCCTTAAGTACTCATGC
GTATTCGAGGTACCCGAGGC -> TATTCGAGGTACCCGAGGCG
TGCGCCGTGTACGCCCTGCT -> GCGCCGTGTACGCCCTGCTC
ATGCGACACGTAATAACTGT -> TGCGACACGTAATAACTGTT
CCTTCGCGCACCTGTACTAG -> CTTCGCGCACCTGTACTAGC
TTAGTCTGTGTGTAGGGTGC -> TAGTCTGTGTGTAGGGTGCA
GTGGAGATGCGACACGTAAT -> TGGAGATGCGACACGTAATA
CGTCGTAGCGACAATTGTTG -> GTCGTAGCGACAATTGTTGC
GGCTAACCATAGTAACGGTG -> GCTAACCATAGTAACGGTGA
AGAAAGTGCCAGCCTAATCC -> GAAAGTGCCAGCCTAATCCC
GATCATCCAAGCTCTGTAAA -> ATCATCCAAGCTCTGTAAAT
CCCGAGGCGTCCCGAATACT -> CCGAGGCGTCCCGAATACTC
ACTAGAGGTCGCACTAAATG -> CTAGAGGTCGCACTAAATGA
TGTCCCCTCGTATTCGAGGT -> GTCCCCTCGTATTCGAGGTA
TATGAACCGAAAGTAAATTT -> ATGAACCGAAAGTAAATTTA
GAGGTACCCGAGGCGTCCCG -> AGGTACCCGAGGCGTCCCGA
CTTTCGATTTACCTTAGCAC -> TTTCGATTTACCTTAGCACA
AGCTCTGTAAATGGTTGTTC -> GCTCTGTAAATGGTTGTTCG
CGTGTCGAGACACAGTGGTG -> GTGTCGAGACACAGTGGTGA
CTGGTGCAAATAACTGTCGG -> TGGTGCAAATAACTGTCGGG
TTCTCCCTTATTTACAATGT -> TCTCCCTTATTTACAATGTA
TTCCGGCTGTCTGTGCCTGT -> TCCGGCTGTCTGTGCCTGTC
CTAGGGTCTAACGACTTAAC -> TAGGGTCTAACGACTTAACT
CTGCTGGTGCAAATAACTGT -> TGCTGGTGCAAATAACTGTC
CTTAGATATCTTAGGAGCCG -> TTAGATATCTTAGGAGCCGT
TGACCGGACCCGTCTTTGTG -> GACCGGACCCGTCTTTGTGT
TATTCGAGGTACCCGAGGCG -> ATTCGAGGTACCCGAGGCGT
TGCACACTTCGTGTGGAGCG -> GCACACTTCGTGTGGAGCGC
AGGACCCCGGTGAGATCATC -> GGACCCCGGTGAGATCATCC
CTCTGACTCTCGGAAGTCGT -> TCTGACTCTCGGAAGTCGTT
AATACCGTTCGTATAAAGAG -> ATACCGTTCGTATAAAGAGC
GCTGTCTGTGCCTGTCGACA -> CTGTCTGTGCCTGTCGACAA
CATCCAGGGCTAACCATAGT -> ATCCAGGGCTAACCATAGTA
ACCACTATGGGACTGCTGGT -> CCACTATGGGACTGCTGGTG
GTACTTAATCATGTCCCCTC -> TACTTAATCATGTCCCCTCG
CTCTGTAAATGGTTGTTCGG -> TCTGTAAATGGTTGTTCGGA
CCTGTCGACAATGTGCTGAT -> CTGTCGACAATGTGCTGATC
AGTCTGTGTGTAGGGTGCAC -> GTCTGTGTGTAGGGTGCACA
GCTTAGATATCTTAGGAGCC -> CTTAGATATCTTAGGAGCCG
TACTAGCTACCCTAACTTTC -> ACTAGCTACCCTAACTTTCG
CCCACTTCATTCTCCCTTAT -> CCACTTCATTCTCCCTTATT
GCTTGGTTTGTCGCTCTTAT -> CTTGGTTTGTCGCTCTTATT
GAACCACTATGGGACTGCTG -> AACCACTATGGGACTGCTGG
GGATCGACGTATGCGCCGTG -> GATCGACGTATGCGCCGTGT
GCTCTTATTCGGTATCAAAC -> CTCTTATTCGGTATCAAACA
AGGCGCTACGGAGTTTTTCA -> GGCGCTACGGAGTTTTTCAT
TAGCTACCCTAACTTTCGAT -> AGCTACCCTAACTTTCGATT
ACTGTCGGGGCATATCCTAG -> CTGTCGGGGCATATCCTAGA
TTGCCGGTGGAGATGCGACA -> TGCCGGTGGAGATGCGACAC
CGAGGCGTCCCGAATACTCG -> GAGGCGTCCCGAATACTCGG
TCGGAGGGGCGGGTGCGCAC -> CGGAGGGGCGGGTGCGCACC
ACAATTGTTGCTTGGTTTGT -> CAATTGTTGCTTGGTTTGTC
CGCCGTGTACGCCCTGCTCC -> GCCGTGTACGCCCTGCTCCC
TGATCGGATCGACGTATGCG -> GATCGGATCGACGTATGCGC
GGACCCGTCTTTGTGTTAGA -> GACCCGTCTTTGTGTTAGAA
CGTAAACATCTGTCGTCGTA -> GTAAACATCTGTCGTCGTAG
GCCGTCATGGCTTCAGTGAT -> CCGTCATGGCTTCAGTGATG
AGGAGCCGTCATGGCTTCAG -> GGAGCCGTCATGGCTTCAGT
CTCTCGGAAGTCGTTTAGGA -> TCTCGGAAGTCGTTTAGGAC
GTGATCGGATCGACGTATGC -> TGATCGGATCGACGTATGCG
CTTAAGTACTCATGCCCCGA -> TTAAGTACTCATGCCCCGAG
GACTGCTGGTGCAAATAACT -> ACTGCTGGTGCAAATAACTG
CTTATTTACAATGTAGCCCT -> TTATTTACAATGTAGCCCTT
AGTGATGCTGGGGTACTTAA -> GTGATGCTGGGGTACTTAAT
GTATGCGCCGTGTACGCCCT -> TATGCGCCGTGTACGCCCTG
AAACGGTTAGGATCAGCTTA -> AACGGTTAGGATCAGCTTAG
TAATAACTGTTGAGTCTAAT -> AATAACTGTTGAGTCTAATC
GGACCCCGGTGAGATCATCC -> GACCCCGGTGAGATCATCCA
AGACTCATAAATACCGTTCG -> GACTCATAAATACCGTTCGT
GTTGTTCGGAGGGGCGGGTG -> TTGTTCGGAGGGGCGGGTGC
TGTTGAGTCTAATCTTAGAG -> GTTGAGTCTAATCTTAGAGC
GGGCATATCCTAGACTTTTG -> GGCATATCCTAGACTTTTGC
TTCTTAGTGTAAGAGCAAAT -> TCTTAGTGTAAGAGCAAATT
GGGGCATATCCTAGACTTTT -> GGGCATATCCTAGACTTTTG
GCCGGTGGAGATGCGACACG -> CCGGTGGAGATGCGACACGT
CTTCGCGCACCTGTACTAGC -> TTCGCGCACCTGTACTAGCT
ACTACGTGTCGAGACACAGT -> CTACGTGTCGAGACACAGTG
GATCGACGTATGCGCCGTGT -> ATCGACGTATGCGCCGTGTA
GCACCTGTACTAGCTACCCT -> CACCTGTACTAGCTACCCTA
CTAGACTTTTGCTACGCACA -> TAGACTTTTGCTACGCACAT
CCCGAGAATTACGTAAACAT -> CCGAGAATTACGTAAACATC
GGAGATGCGACACGTAATAA -> GAGATGCGACACGTAATAAC
CTCGTTGCCGGTGGAGATGC -> TCGTTGCCGGTGGAGATGCG
TCCCTTCGCGCACCTGTACT -> CCCTTCGCGCACCTGTACTA
TCTTATTCGGTATCAAACAG -> CTTATTCGGTATCAAACAGA
ATACCGTTCGTATAAAGAGC -> TACCGTTCGTATAAAGAGCC
GGCTGTCTGTGCCTGTCGAC -> GCTGTCTGTGCCTGTCGACA
TTTTGCTACGCACATCCAGG -> TTTGCTACGCACATCCAGGG
CATTAATTAACAATTCGCTT -> ATTAATTAACAATTCGCTTA
AACTGTCGGGGCATATCCTA -> ACTGTCGGGGCATATCCTAG
AGATTACAGACTCATAAATA -> GATTACAGACTCATAAATAC
ACAAATCAGTACTATATTCT -> CAAATCAGTACTATATTCTT
CTAATCTTAGAGCGATGGAG -> TAATCTTAGAGCGATGGAGG
TAACGACTTAACTACGTGTC -> AACGACTTAACTACGTGTCG
ACCCTAACTTTCGATTTACC -> CCCTAACTTTCGATTTACCT
TCATCTCGTTGCCGGTGGAG -> CATCTCGTTGCCGGTGGAGA
GTACGCCCTGCTCCCTTCGC -> TACGCCCTGCTCCCTTCGCG
CTACGCACATCCAGGGCTAA -> TACGCACATCCAGGGCTAAC
ATGCCCCGAGAATTACGTAA -> TGCCCCGAGAATTACGTAAA
TCATAAATACCGTTCGTATA -> CATAAATACCGTTCGTATAA
TCCCGAATACTCGGACCGGC -> CCCGAATACTCGGACCGGCC
CGAGGTACCCGAGGCGTCCC -> GAGGTACCCGAGGCGTCCCG
CTAATCCCATTAATTAACAA -> TAATCCCATTAATTAACAAT
TTACGTAAACATCTGTCGTC -> TACGTAAACATCTGTCGTCG
GACTTTTGCTACGCACATCC -> ACTTTTGCTACGCACATCCA
AGCACAGAAAGTGCCAGCCT -> GCACAGAAAGTGCCAGCCTA
CTCTTATTCGGTATCAAACA -> TCTTATTCGGTATCAAACAG
AATACAAATCAGTACTATAT -> ATACAAATCAGTACTATATT
ATCGGATCGACGTATGCGCC -> TCGGATCGACGTATGCGCCG
GTTAGAATACAAATCAGTAC -> TTAGAATACAAATCAGTACT
ATGCTGGGGTACTTAATCAT -> TGCTGGGGTACTTAATCATG
ATCAGCTTAGATATCTTAGG -> TCAGCTTAGATATCTTAGGA
AAAGAGCCCACTTCATTCTC -> AAGAGCCCACTTCATTCTCC
AACAGATTACAGACTCATAA -> ACAGATTACAGACTCATAAA
CCCGGTGAGATCATCCAAGC -> CCGGTGAGATCATCCAAGCT
TTAAGTACTCATGCCCCGAG -> TAAGTACTCATGCCCCGAGA
GTGTCGAGACACAGTGGTGA -> TGTCGAGACACAGTGGTGAT
TAGGACCCCGGTGAGATCAT -> AGGACCCCGGTGAGATCATC
CCTAACTTTCGATTTACCTT -> CTAACTTTCGATTTACCTTA
AGTTTTTCATCTCGTTGCCG -> GTTTTTCATCTCGTTGCCGG
CTTAGGAGCCGTCATGGCTT -> TTAGGAGCCGTCATGGCTTC
TTTACAATGTAGCCCTTAGT -> TTACAATGTAGCCCTTAGTT
AATCAGTACTATATTCTTAG -> ATCAGTACTATATTCTTAGT
TGTGCCTGTCGACAATGTGC -> GTGCCTGTCGACAATGTGCT
CTGACCGGACCCGTCTTTGT -> TGACCGGACCCGTCTTTGTG
TCATGGCTTCAGTGATGCTG -> CATGGCTTCAGTGATGCTGG
AGAATTACGTAAACATCTGT -> GAATTACGTAAACATCTGTC
AACTGACCGGACCCGTCTTT -> ACTGACCGGACCCGTCTTTG
TGCCGGTGGAGATGCGACAC -> GCCGGTGGAGATGCGACACG
TCTGTAAATGGTTGTTCGGA -> CTGTAAATGGTTGTTCGGAG
TTCGGTATCAAACAGATTAC -> TCGGTATCAAACAGATTACA
CCGTCTTTGTGTTAGAATAC -> CGTCTTTGTGTTAGAATACA
TCGGGGCATATCCTAGACTT -> CGGGGCATATCCTAGACTTT
TTCAGTGATGCTGGGGTACT -> TCAGTGATGCTGGGGTACTT
TAGAGGTCGCACTAAATGAT -> AGAGGTCGCACTAAATGATT
GTCTGTGCCTGTCGACAATG -> TCTGTGCCTGTCGACAATGT
CATAAATACCGTTCGTATAA -> ATAAATACCGTTCGTATAAA
ACAGTGGTGATCGGATCGAC -> CAGTGGTGATCGGATCGACG
GCGCCGTGTACGCCCTGCTC -> CGCCGTGTACGCCCTGCTCC
AATACGCTAGGGTCTAACGA -> ATACGCTAGGGTCTAACGAC
TAGAGCGATGGAGGGTCGAA -> AGAGCGATGGAGGGTCGAAC
CGCACCTGTACTAGCTACCC -> GCACCTGTACTAGCTACCCT
ACTTTTGCTACGCACATCCA -> CTTTTGCTACGCACATCCAG
TCGCACTAAATGATTTTGAT -> CGCACTAAATGATTTTGATA
AAACATCTGTCGTCGTAGCG -> AACATCTGTCGTCGTAGCGA
ATCTTAGAGCGATGGAGGGT -> TCTTAGAGCGATGGAGGGTC
ATTCGCTTACTAGAGGTCGC -> TTCGCTTACTAGAGGTCGCA
CAGAAAGTGCCAGCCTAATC -> AGAAAGTGCCAGCCTAATCC
CGGCTCTGACTCTCGGAAGT -> GGCTCTGACTCTCGGAAGTC
GTCGTAGCGACAATTGTTGC -> TCGTAGCGACAATTGTTGCT
CCGGTGGAGATGCGACACGT -> CGGTGGAGATGCGACACGTA
TGACTCTCGGAAGTCGTTTA -> GACTCTCGGAAGTCGTTTAG
TGTCGAGACACAGTGGTGAT -> GTCGAGACACAGTGGTGATC
GCTAGGGTCTAACGACTTAA -> CTAGGGTCTAACGACTTAAC
GAGACACAGTGGTGATCGGA -> AGACACAGTGGTGATCGGAT
AGTCGTTTAGGACCCCGGTG -> GTCGTTTAGGACCCCGGTGA
TGTCGACAATGTGCTGATCT -> GTCGACAATGTGCTGATCTC
CTACGGAGTTTTTCATCTCG -> TACGGAGTTTTTCATCTCGT
TCGCTCTTATTCGGTATCAA -> CGCTCTTATTCGGTATCAAA
AGATGCGACACGTAATAACT -> GATGCGACACGTAATAACTG
GGACTGCTGGTGCAAATAAC -> GACTGCTGGTGCAAATAACT
CCGGTGAGATCATCCAAGCT -> CGGTGAGATCATCCAAGCTC
GAGTCTAATCTTAGAGCGAT -> AGTCTAATCTTAGAGCGATG
TTGTTCGGAGGGGCGGGTGC -> TGTTCGGAGGGGCGGGTGCG
CTTTGTGTTAGAATACAAAT -> TTTGTGTTAGAATACAAATC
GGGCTAACCATAGTAACGGT -> GGCTAACCATAGTAACGGTG
TTGTTGCTTGGTTTGTCGCT -> TGTTGCTTGGTTTGTCGCTC
ACCCCGGTGAGATCATCCAA -> CCCCGGTGAGATCATCCAAG
CGTGTACGCCCTGCTCCCTT -> GTGTACGCCCTGCTCCCTTC
TAACTGACCGGACCCGTCTT -> AACTGACCGGACCCGTCTTT
TCGACAATGTGCTGATCTCA -> CGACAATGTGCTGATCTCAC
TCTCGGAAGTCGTTTAGGAC -> CTCGGAAGTCGTTTAGGACC
GGTCTAACGACTTAACTACG -> GTCTAACGACTTAACTACGT
AATTGTTGCTTGGTTTGTCG -> ATTGTTGCTTGGTTTGTCGC
TCCAGGGCTAACCATAGTAA -> CCAGGGCTAACCATAGTAAC
AGCAAATTATTTTCCGGCTG -> GCAAATTATTTTCCGGCTGT
ACAATGTGCTGATCTCACTT -> CAATGTGCTGATCTCACTTA
TTACCTTAGCACAGAAAGTG -> TACCTTAGCACAGAAAGTGC
GACCGGACCCGTCTTTGTGT -> ACCGGACCCGTCTTTGTGTT
CTCGGAAGTCGTTTAGGACC -> TCGGAAGTCGTTTAGGACCC
CCCCGAGAATTACGTAAACA -> CCCGAGAATTACGTAAACAT
ACTGACCGGACCCGTCTTTG -> CTGACCGGACCCGTCTTTGT
ACCGTAAACGGTTAGGATCA -> CCGTAAACGGTTAGGATCAG
AATTATTTTCCGGCTGTCTG -> ATTATTTTCCGGCTGTCTGT
GTAAGAGCAAATTATTTTCC -> TAAGAGCAAATTATTTTCCG
GATATGAACCGAAAGTAAAT -> ATATGAACCGAAAGTAAATT
TGCAAATAACTGTCGGGGCA -> GCAAATAACTGTCGGGGCAT
AAATTATTTTCCGGCTGTCT -> AATTATTTTCCGGCTGTCTG
CCATAGTAACGGTGACGCCC -> CATAGTAACGGTGACGCCCT
CAGCCTAATCCCATTAATTA -> AGCCTAATCCCATTAATTAA
AGTCTAATCTTAGAGCGATG -> GTCTAATCTTAGAGCGATGG
TATTTTCCGGCTGTCTGTGC -> ATTTTCCGGCTGTCTGTGCC
GCCGTGTACGCCCTGCTCCC -> CCGTGTACGCCCTGCTCCCT
TTATAACTGACCGGACCCGT -> TATAACTGACCGGACCCGTC
GGAGGGGCGGGTGCGCACCT -> GAGGGGCGGGTGCGCACCTA
TTATTCGGTATCAAACAGAT -> TATTCGGTATCAAACAGATT
GGCCTGTTTCCGGCTAACAT -> GCCTGTTTCCGGCTAACATC
CTGTGTGTAGGGTGCACACT -> TGTGTGTAGGGTGCACACTT
CGGAGTTTTTCATCTCGTTG -> GGAGTTTTTCATCTCGTTGC
ACTTCGTGTGGAGCGCGGCT -> CTTCGTGTGGAGCGCGGCTC
TACGGAGTTTTTCATCTCGT -> ACGGAGTTTTTCATCTCGTT
CGCGGCTCTGACTCTCGGAA -> GCGGCTCTGACTCTCGGAAG
GAGGGGCGGGTGCGCACCTA -> AGGGGCGGGTGCGCACCTAT
AAGTACTCATGCCCCGAGAA -> AGTACTCATGCCCCGAGAAT
AAAGTGCCAGCCTAATCCCA -> AAGTGCCAGCCTAATCCCAT
TTAGAATACAAATCAGTACT -> TAGAATACAAATCAGTACTA
GACTTAACTACGTGTCGAGA -> ACTTAACTACGTGTCGAGAC
CTACGTGTCGAGACACAGTG -> TACGTGTCGAGACACAGTGG
CTGACTCTCGGAAGTCGTTT -> TGACTCTCGGAAGTCGTTTA
TCCTCTATTAGTGAATACGC -> CCTCTATTAGTGAATACGCT
ACTAGCTACCCTAACTTTCG -> CTAGCTACCCTAACTTTCGA
GGTGCACACTTCGTGTGGAG -> GTGCACACTTCGTGTGGAGC
TCTTAGTGTAAGAGCAAATT -> CTTAGTGTAAGAGCAAATTA
ACCTATCTATTTAACTCACG -> CCTATCTATTTAACTCACGA
CTTCAGTGATGCTGGGGTAC -> TTCAGTGATGCTGGGGTACT
ACCCGTCTTTGTGTTAGAAT -> CCCGTCTTTGTGTTAGAATA
TACGTAAACATCTGTCGTCG -> ACGTAAACATCTGTCGTCGT
CATGCCCCGAGAATTACGTA -> ATGCCCCGAGAATTACGTAA
CCGGCCTGTTTCCGGCTAAC -> CGGCCTGTTTCCGGCTAACA
TTAGCACAGAAAGTGCCAGC -> TAGCACAGAAAGTGCCAGCC
CCGGACCCGTCTTTGTGTTA -> CGGACCCGTCTTTGTGTTAG
CATTCTCCCTTATTTACAAT -> ATTCTCCCTTATTTACAATG
AGGGGCGGGTGCGCACCTAT -> GGGGCGGGTGCGCACCTATC
GTACCCGAGGCGTCCCGAAT -> TACCCGAGGCGTCCCGAATA
AATTAACAATTCGCTTACTA -> ATTAACAATTCGCTTACTAG
GCGCGGCTCTGACTCTCGGA -> CGCGGCTCTGACTCTCGGAA
GAGATGCGACACGTAATAAC -> AGATGCGACACGTAATAACT
GTGCTGATCTCACTTAGTCT -> TGCTGATCTCACTTAGTCTG
CCGTCATGGCTTCAGTGATG -> CGTCATGGCTTCAGTGATGC
TAAGAGCAAATTATTTTCCG -> AAGAGCAAATTATTTTCCGG
TTCATTCTCCCTTATTTACA -> TCATTCTCCCTTATTTACAA
TATCAAACAGATTACAGACT -> ATCAAACAGATTACAGACTC
GGTGATCGGATCGACGTATG -> GTGATCGGATCGACGTATGC
TTGCTACGCACATCCAGGGC -> TGCTACGCACATCCAGGGCT
ACAATGTAGCCCTTAGTTTC -> CAATGTAGCCCTTAGTTTCC
GTGTGTAGGGTGCACACTTC -> TGTGTAGGGTGCACACTTCG
GTGTAGGGTGCACACTTCGT -> TGTAGGGTGCACACTTCGTG
GGTCGAACCACTATGGGACT -> GTCGAACCACTATGGGACTG
AACATCTGTCGTCGTAGCGA -> ACATCTGTCGTCGTAGCGAC
TTACTAGAGGTCGCACTAAA -> TACTAGAGGTCGCACTAAAT
CACGTAATAACTGTTGAGTC -> ACGTAATAACTGTTGAGTCT
AGGATCAGCTTAGATATCTT -> GGATCAGCTTAGATATCTTA
GCTTACTAGAGGTCGCACTA -> CTTACTAGAGGTCGCACTAA
TTGTCGCTCTTATTCGGTAT -> TGTCGCTCTTATTCGGTATC
TTCACGTTTACCGTAAACGG -> TCACGTTTACCGTAAACGGT
TATCCTAGACTTTTGCTACG -> ATCCTAGACTTTTGCTACGC
GAATTACGTAAACATCTGTC -> AATTACGTAAACATCTGTCG
TCGATTTACCTTAGCACAGA -> CGATTTACCTTAGCACAGAA
ACGACTTAACTACGTGTCGA -> CGACTTAACTACGTGTCGAG
ATAACTGACCGGACCCGTCT -> TAACTGACCGGACCCGTCTT
GAGCGATGGAGGGTCGAACC -> AGCGATGGAGGGTCGAACCA
TGTTAGAATACAAATCAGTA -> GTTAGAATACAAATCAGTAC
CAATGTAGCCCTTAGTTTCC -> AATGTAGCCCTTAGTTTCCT
TTCGCGCACCTGTACTAGCT -> TCGCGCACCTGTACTAGCTA
CTAAATGATTTTGATATGAA -> TAAATGATTTTGATATGAAC
GGGTCTAACGACTTAACTAC -> GGTCTAACGACTTAACTACG
CAATTCGCTTACTAGAGGTC -> AATTCGCTTACTAGAGGTCG
AACGACTTAACTACGTGTCG -> ACGACTTAACTACGTGTCGA
TACTATATTCTTAGTGTAAG -> ACTATATTCTTAGTGTAAGA
GTCGCACTAAATGATTTTGA -> TCGCACTAAATGATTTTGAT
CGAGCGGTATTATAATTCAC -> GAGCGGTATTATAATTCACG
TTAGTGAATACGCTAGGGTC -> TAGTGAATACGCTAGGGTCT
GACACGTAATAACTGTTGAG -> ACACGTAATAACTGTTGAGT
CGTATTCGAGGTACCCGAGG -> GTATTCGAGGTACCCGAGGC
GAAGTCGTTTAGGACCCCGG -> AAGTCGTTTAGGACCCCGGT
TGTACGCCCTGCTCCCTTCG -> GTACGCCCTGCTCCCTTCGC
TGCGACACGTAATAACTGTT -> GCGACACGTAATAACTGTTG
GCTTCAGTGATGCTGGGGTA -> CTTCAGTGATGCTGGGGTAC
CGGTGGAGATGCGACACGTA -> GGTGGAGATGCGACACGTAA
AAATCAGTACTATATTCTTA -> AATCAGTACTATATTCTTAG
TGCTACGCACATCCAGGGCT -> GCTACGCACATCCAGGGCTA
GGGTACTTAATCATGTCCCC -> GGTACTTAATCATGTCCCCT
GTGCACACTTCGTGTGGAGC -> TGCACACTTCGTGTGGAGCG
GTGTCAGGCGCTACGGAGTT -> TGTCAGGCGCTACGGAGTTT
CCAGGGCTAACCATAGTAAC -> CAGGGCTAACCATAGTAACG
CACTAAATGATTTTGATATG -> ACTAAATGATTTTGATATGA
GGGTGCGCACCTATCTATTT -> GGTGCGCACCTATCTATTTA
GACAATTGTTGCTTGGTTTG -> ACAATTGTTGCTTGGTTTGT
TTTCCGGCTGTCTGTGCCTG -> TTCCGGCTGTCTGTGCCTGT
TAATTAACAATTCGCTTACT -> AATTAACAATTCGCTTACTA
TTTGTGTTAGAATACAAATC -> TTGTGTTAGAATACAAATCA
TACCGTAAACGGTTAGGATC -> ACCGTAAACGGTTAGGATCA
CGTAAACGGTTAGGATCAGC -> GTAAACGGTTAGGATCAGCT
CGGTATTATAATTCACGTTT -> GGTATTATAATTCACGTTTA
TATTATAATTCACGTTTACC -> ATTATAATTCACGTTTACCG
TTAACTACGTGTCGAGACAC -> TAACTACGTGTCGAGACACA
TGAGTCTAATCTTAGAGCGA -> GAGTCTAATCTTAGAGCGAT
TCCTAGACTTTTGCTACGCA -> CCTAGACTTTTGCTACGCAC
AACGGTGACGCCCTTAAGTA -> ACGGTGACGCCCTTAAGTAC
CTGTTGAGTCTAATCTTAGA -> TGTTGAGTCTAATCTTAGAG
GCACAGAAAGTGCCAGCCTA -> CACAGAAAGTGCCAGCCTAA
CCCTCGTATTCGAGGTACCC -> CCTCGTATTCGAGGTACCCG
GCAAATAACTGTCGGGGCAT -> CAAATAACTGTCGGGGCATA
CTGTGCCTGTCGACAATGTG -> TGTGCCTGTCGACAATGTGC
TACCGTTCGTATAAAGAGCC -> ACCGTTCGTATAAAGAGCCC
CTAGCTACCCTAACTTTCGA -> TAGCTACCCTAACTTTCGAT
GCGCACCTGTACTAGCTACC -> CGCACCTGTACTAGCTACCC
ATGAACCGAAAGTAAATTTA -> TGAACCGAAAGTAAATTTAT
ACTCATAAATACCGTTCGTA -> CTCATAAATACCGTTCGTAT
ATGTCCCCTCGTATTCGAGG -> TGTCCCCTCGTATTCGAGGT
TGGAGCGCGGCTCTGACTCT -> GGAGCGCGGCTCTGACTCTC
TTTAGGACCCCGGTGAGATC -> TTAGGACCCCGGTGAGATCA
TTATTTTCCGGCTGTCTGTG -> TATTTTCCGGCTGTCTGTGC
ATTAGTGAATACGCTAGGGT -> TTAGTGAATACGCTAGGGTC
GGTGAGATCATCCAAGCTCT -> GTGAGATCATCCAAGCTCTG
GTAAACATCTGTCGTCGTAG -> TAAACATCTGTCGTCGTAGC
CGTGTGGAGCGCGGCTCTGA -> GTGTGGAGCGCGGCTCTGAC
ACGCCCTTAAGTACTCATGC -> CGCCCTTAAGTACTCATGCC
GAGCGCGGCTCTGACTCTCG -> AGCGCGGCTCTGACTCTCGG
CGGGTGCGCACCTATCTATT -> GGGTGCGCACCTATCTATTT
AGTACTATATTCTTAGTGTA -> GTACTATATTCTTAGTGTAA
AAGCTCTGTAAATGGTTGTT -> AGCTCTGTAAATGGTTGTTC
TTTATAACTGACCGGACCCG -> TTATAACTGACCGGACCCGT
TCGCGCACCTGTACTAGCTA -> CGCGCACCTGTACTAGCTAC
GCCCCGAGAATTACGTAAAC -> CCCCGAGAATTACGTAAACA
GGGGTACTTAATCATGTCCC -> GGGTACTTAATCATGTCCCC
CACGAGCGGTATTATAATTC -> ACGAGCGGTATTATAATTCA
GTTGAGTCTAATCTTAGAGC -> TTGAGTCTAATCTTAGAGCG
CCGAAAGTAAATTTATAACT -> CGAAAGTAAATTTATAACTG
TGGAGGGTCGAACCACTATG -> GGAGGGTCGAACCACTATGG
ACCGGACCCGTCTTTGTGTT -> CCGGACCCGTCTTTGTGTTA
CACTTCATTCTCCCTTATTT -> ACTTCATTCTCCCTTATTTA
CGTATGCGCCGTGTACGCCC -> GTATGCGCCGTGTACGCCCT
CAGGCGCTACGGAGTTTTTC -> AGGCGCTACGGAGTTTTTCA
CCGAGAATTACGTAAACATC -> CGAGAATTACGTAAACATCT
ATGGCTTCAGTGATGCTGGG -> TGGCTTCAGTGATGCTGGGG
ATTCGAGGTACCCGAGGCGT -> TTCGAGGTACCCGAGGCGTC
ACTTTCGATTTACCTTAGCA -> CTTTCGATTTACCTTAGCAC
CGCTAGGGTCTAACGACTTA -> GCTAGGGTCTAACGACTTAA
GCGCACCTATCTATTTAACT -> CGCACCTATCTATTTAACTC
TCCCCTCGTATTCGAGGTAC -> CCCCTCGTATTCGAGGTACC
GATTTTGATATGAACCGAAA -> ATTTTGATATGAACCGAAAG
CTCACGAGCGGTATTATAAT -> TCACGAGCGGTATTATAATT
TCTCGTTGCCGGTGGAGATG -> CTCGTTGCCGGTGGAGATGC
TGCCCCGAGAATTACGTAAA -> GCCCCGAGAATTACGTAAAC
TAACTCACGAGCGGTATTAT -> AACTCACGAGCGGTATTATA
GGAGCCGTCATGGCTTCAGT -> GAGCCGTCATGGCTTCAGTG
TGCGCACCTATCTATTTAAC -> GCGCACCTATCTATTTAACT
CTGATCTCACTTAGTCTGTG -> TGATCTCACTTAGTCTGTGT
GCGGGTGCGCACCTATCTAT -> CGGGTGCGCACCTATCTATT
GGTACCCGAGGCGTCCCGAA -> GTACCCGAGGCGTCCCGAAT
CCGGCTGTCTGTGCCTGTCG -> CGGCTGTCTGTGCCTGTCGA
GTGCGCACCTATCTATTTAA -> TGCGCACCTATCTATTTAAC
CGAAAGTAAATTTATAACTG -> GAAAGTAAATTTATAACTGA
TACGTGTCGAGACACAGTGG -> ACGTGTCGAGACACAGTGGT
CCGAATACTCGGACCGGCCT -> CGAATACTCGGACCGGCCTG
CACAGAAAGTGCCAGCCTAA -> ACAGAAAGTGCCAGCCTAAT
ACTCACGAGCGGTATTATAA -> CTCACGAGCGGTATTATAAT
ACTTCATTCTCCCTTATTTA -> CTTCATTCTCCCTTATTTAC
TTCCTCTATTAGTGAATACG -> TCCTCTATTAGTGAATACGC
GACCGGCCTGTTTCCGGCTA -> ACCGGCCTGTTTCCGGCTAA
TAATCTTAGAGCGATGGAGG -> AATCTTAGAGCGATGGAGGG
GAATACTCGGACCGGCCTGT -> AATACTCGGACCGGCCTGTT
GAGAATTACGTAAACATCTG -> AGAATTACGTAAACATCTGT
ACGTAATAACTGTTGAGTCT -> CGTAATAACTGTTGAGTCTA
CCTAATCCCATTAATTAACA -> CTAATCCCATTAATTAACAA
GTCGAACCACTATGGGACTG -> TCGAACCACTATGGGACTGC
TTGTGTTAGAATACAAATCA -> TGTGTTAGAATACAAATCAG
TAGGAGCCGTCATGGCTTCA -> AGGAGCCGTCATGGCTTCAG
GGTACTTAATCATGTCCCCT -> GTACTTAATCATGTCCCCTC
CGACTTAACTACGTGTCGAG -> GACTTAACTACGTGTCGAGA
CTAGAGGTCGCACTAAATGA -> TAGAGGTCGCACTAAATGAT
ATATTCTTAGTGTAAGAGCA -> TATTCTTAGTGTAAGAGCAA
GAATACGCTAGGGTCTAACG -> AATACGCTAGGGTCTAACGA
ATCTTAGGAGCCGTCATGGC -> TCTTAGGAGCCGTCATGGCT
AATGGTTGTTCGGAGGGGCG -> ATGGTTGTTCGGAGGGGCGG
CTAACCATAGTAACGGTGAC -> TAACCATAGTAACGGTGACG
CAAGCTCTGTAAATGGTTGT -> AAGCTCTGTAAATGGTTGTT
GACTCTCGGAAGTCGTTTAG -> ACTCTCGGAAGTCGTTTAGG
CGTAATAACTGTTGAGTCTA -> GTAATAACTGTTGAGTCTAA
GCTCTGACTCTCGGAAGTCG -> CTCTGACTCTCGGAAGTCGT
TCGTATAAAGAGCCCACTTC -> CGTATAAAGAGCCCACTTCA
GACACAGTGGTGATCGGATC -> ACACAGTGGTGATCGGATCG
ACTCTCGGAAGTCGTTTAGG -> CTCTCGGAAGTCGTTTAGGA
GCTAACCATAGTAACGGTGA -> CTAACCATAGTAACGGTGAC
GTGAGATCATCCAAGCTCTG -> TGAGATCATCCAAGCTCTGT
TAGGGTCTAACGACTTAACT -> AGGGTCTAACGACTTAACTA
CAGTGATGCTGGGGTACTTA -> AGTGATGCTGGGGTACTTAA
TATAACTGACCGGACCCGTC -> ATAACTGACCGGACCCGTCT
TGATTTTGATATGAACCGAA -> GATTTTGATATGAACCGAAA
TAGTCTGTGTGTAGGGTGCA -> AGTCTGTGTGTAGGGTGCAC
TAAAGAGCCCACTTCATTCT -> AAAGAGCCCACTTCATTCTC
TACCTTAGCACAGAAAGTGC -> ACCTTAGCACAGAAAGTGCC
GATTTACCTTAGCACAGAAA -> ATTTACCTTAGCACAGAAAG
AGCCGTCATGGCTTCAGTGA -> GCCGTCATGGCTTCAGTGAT
CCGTAAACGGTTAGGATCAG -> CGTAAACGGTTAGGATCAGC
ATCATCCAAGCTCTGTAAAT -> TCATCCAAGCTCTGTAAATG
TTAGAGCGATGGAGGGTCGA -> TAGAGCGATGGAGGGTCGAA
AGTACTCATGCCCCGAGAAT -> GTACTCATGCCCCGAGAATT
AACTACGTGTCGAGACACAG -> ACTACGTGTCGAGACACAGT
AACTGTTGAGTCTAATCTTA -> ACTGTTGAGTCTAATCTTAG
GGACCGGCCTGTTTCCGGCT -> GACCGGCCTGTTTCCGGCTA
GCACACTTCGTGTGGAGCGC -> CACACTTCGTGTGGAGCGCG
TGCTTGGTTTGTCGCTCTTA -> GCTTGGTTTGTCGCTCTTAT
GTCAGGCGCTACGGAGTTTT -> TCAGGCGCTACGGAGTTTTT
GTGTGGAGCGCGGCTCTGAC -> TGTGGAGCGCGGCTCTGACT
CCCTTCGCGCACCTGTACTA -> CCTTCGCGCACCTGTACTAG
ATCGACGTATGCGCCGTGTA -> TCGACGTATGCGCCGTGTAC
ATATGAACCGAAAGTAAATT -> TATGAACCGAAAGTAAATTT
GCGTCCCGAATACTCGGACC -> CGTCCCGAATACTCGGACCG
TGACGCCCTTAAGTACTCAT -> GACGCCCTTAAGTACTCATG
GCGACAATTGTTGCTTGGTT -> CGACAATTGTTGCTTGGTTT
CTGTCGACAATGTGCTGATC -> TGTCGACAATGTGCTGATCT
ACGAGCGGTATTATAATTCA -> CGAGCGGTATTATAATTCAC
GCTGATCTCACTTAGTCTGT -> CTGATCTCACTTAGTCTGTG
GTGAATACGCTAGGGTCTAA -> TGAATACGCTAGGGTCTAAC
AATTACGTAAACATCTGTCG -> ATTACGTAAACATCTGTCGT
GAGGCGTCCCGAATACTCGG -> AGGCGTCCCGAATACTCGGA
CTATTTAACTCACGAGCGGT -> TATTTAACTCACGAGCGGTA
TGTTGCTTGGTTTGTCGCTC -> GTTGCTTGGTTTGTCGCTCT
ATATCTTAGGAGCCGTCATG -> TATCTTAGGAGCCGTCATGG
GTTTAGGACCCCGGTGAGAT -> TTTAGGACCCCGGTGAGATC
TACTCATGCCCCGAGAATTA -> ACTCATGCCCCGAGAATTAC