ATGCCTTTACGTGTGCGGA -> TGCCTTTACGTGTGCGGAA
TGGGGGCCCTGTGGGCTGG -> GGGGGCCCTGTGGGCTGGG
AAGTCATTTTCGTGGTTAG -> AGTCATTTTCGTGGTTAGC
TAATGCGTAGAAGTCTTCC -> AATGCGTAGAAGTCTTCCA
CCACGCGTATGCCCTCGTC -> CACGCGTATGCCCTCGTCC
AGTGAATTGCGCGCATGCC -> GTGAATTGCGCGCATGCCG
GAAGTACTTGGACGTTCAT -> AAGTACTTGGACGTTCATT
AGAACTTGGTGACCGTGCG -> GAACTTGGTGACCGTGCGA
GCAATCTTACAATAGAACC -> CAATCTTACAATAGAACCG
TTCGTTAATTCCAAGCTAG -> TCGTTAATTCCAAGCTAGA
ATCGGTGGCACTATGGCTA -> TCGGTGGCACTATGGCTAA
GATGCTGGACGAAAGTCTC -> ATGCTGGACGAAAGTCTCG
GCCAAACCGATAATCCCGA -> CCAAACCGATAATCCCGAG
TGACCGGATGTGAAAATGT -> GACCGGATGTGAAAATGTA
ATCCCATACGGCCAAACCG -> TCCCATACGGCCAAACCGA
CGACGAGTCCTTCTGAAGA -> GACGAGTCCTTCTGAAGAC
ACCTTCCTATGCATGGAAG -> CCTTCCTATGCATGGAAGG,CCTTCCTATGCATGGAAGC,CCTTCCTATGCATGGAAGC,CCTTCCTATGCATGGAAGT
TAGGTAGCTTATGATCTAC -> AGGTAGCTTATGATCTACT
AGGCCTATGATGACCTTCC -> GGCCTATGATGACCTTCCT
AAGATGACTGTCCCACACA -> AGATGACTGTCCCACACAG
GAGAGCGAGACATAGCGGA -> AGAGCGAGACATAGCGGAG
TCACACCTATTCCGCAGGA -> CACACCTATTCCGCAGGAC
TGTCGTAAAACTCCTCGAT -> GTCGTAAAACTCCTCGATA
ATCTACCTCAGTGATTAAT -> TCTACCTCAGTGATTAATA
GGGTACTGGCCCTGGGAGT -> GGTACTGGCCCTGGGAGTA
GTGCTTAGAAACACACCCC -> TGCTTAGAAACACACCCCA
GCCTTTACGTGTGCGGAAG -> CCTTTACGTGTGCGGAAGT
GTCCGACTCGTCCTCCTTT -> TCCGACTCGTCCTCCTTTG
CCCCTCGGGGAGCAGGAAT -> CCCTCGGGGAGCAGGAATC
AAAACTCCTCGATAACGAT -> AAACTCCTCGATAACGATG
CCATCTTAATATCTTGGCC -> CATCTTAATATCTTGGCCA
CATGGAAGCATTCACACAT -> ATGGAAGCATTCACACATT
CATAGCAATCTTACAATAG -> ATAGCAATCTTACAATAGA
CCAATGTTCTAAGTCAGCA -> CAATGTTCTAAGTCAGCAC
GCATGTCGCAATCTTGGCA -> CATGTCGCAATCTTGGCAC
CGTGGTTAGCCCGATGCTG -> GTGGTTAGCCCGATGCTGG
CGCCGCAGCTAAGCTTGAC -> GCCGCAGCTAAGCTTGACT
CATAAACACGTGACGCCGT -> ATAAACACGTGACGCCGTA
CAGTGTTCCAGTTTCGTCG -> AGTGTTCCAGTTTCGTCGG
ATTTCAAGATGACTGTCCC -> TTTCAAGATGACTGTCCCA
GTCGTCAGCCGCGCTGTTT -> TCGTCAGCCGCGCTGTTTA
ACTACTAAAGGTAGCGCGC -> CTACTAAAGGTAGCGCGCC
GTTAGCCCGATGCTGGACG -> TTAGCCCGATGCTGGACGA
TAAGCGCACCACGCCAATT -> AAGCGCACCACGCCAATTG
GCGGCCGCATACGAACTTT -> CGGCCGCATACGAACTTTG
CTTCAATCGTACATGCATC -> TTCAATCGTACATGCATCC
ACGACAATTTAGTGAATTG -> CGACAATTTAGTGAATTGC
GCTGCGCCCTGGATATCCT -> CTGCGCCCTGGATATCCTG
ATCGCCAGAGAAGATATTT -> TCGCCAGAGAAGATATTTG
AACGCGTTCCAATGCGCCC -> ACGCGTTCCAATGCGCCCT
GAGTTAGGTTATTGTCCAT -> AGTTAGGTTATTGTCCATG
GCACTATGGCTAAGAAGAC -> CACTATGGCTAAGAAGACT
GTCCATGGCGCTTGCCCTA -> TCCATGGCGCTTGCCCTAG
CGGTTCAAAAACAATGGGC -> GGTTCAAAAACAATGGGCA
GGGTACCAGAGGGGAGTCC -> GGTACCAGAGGGGAGTCCG
CGCAAGCCAGAAGTACTTG -> GCAAGCCAGAAGTACTTGG
GCCAATTGACATTAGACGA -> CCAATTGACATTAGACGAC
GTACAGCTGGGCTTATGCC -> TACAGCTGGGCTTATGCCT
CCAAATCCACTTGCTTTAC -> CAAATCCACTTGCTTTACC
AGCGCACCACGCCAATTGA -> GCGCACCACGCCAATTGAC
TATAGACGCATAGCAATCT -> ATAGACGCATAGCAATCTT
AAATGTACCTACATGACCT -> AATGTACCTACATGACCTT
GCTTAGAAACACACCCCAT -> CTTAGAAACACACCCCATC
CTTGGACGTTCACGGGTCC -> TTGGACGTTCACGGGTCCC
TGGGCTTATGCCTTTACGT -> GGGCTTATGCCTTTACGTG
CCGATCACATTCCTCAGAC -> CGATCACATTCCTCAGACA
AATCGGGTAACGACAATTT -> ATCGGGTAACGACAATTTA
ATTAAGGATAACAGGCATC -> TTAAGGATAACAGGCATCA
TCGATAACGATGCGGCCGC -> CGATAACGATGCGGCCGCA
CCGATGCTGGACGAAAGTC -> CGATGCTGGACGAAAGTCT
CATCCTCAGAGTTAGGTTA -> ATCCTCAGAGTTAGGTTAT
TGATTGAATTTTGCATGTT -> GATTGAATTTTGCATGTTC
ACTTACGCGACCGCAACCG -> CTTACGCGACCGCAACCGA
AATTTAGTGAATTGCGCGC -> ATTTAGTGAATTGCGCGCA
CAGGCTGTATATTGCGACC -> AGGCTGTATATTGCGACCT
CACGCCAATTGACATTAGA -> ACGCCAATTGACATTAGAC
TGAGCCGTGTTAGCTCACG -> GAGCCGTGTTAGCTCACGG
CCTATGCATGGAAGCCATC -> CTATGCATGGAAGCCATCT
CCTTCCTATGCATGGAAGC -> CTTCCTATGCATGGAAGCC,CTTCCTATGCATGGAAGCA
GCGCTGTTTACTCCAGCAT -> CGCTGTTTACTCCAGCATA
AGGCGGTTCAAAAACAATG -> GGCGGTTCAAAAACAATGG
CCGTGCGATTAATGGGGGC -> CGTGCGATTAATGGGGGCC
TATTGCGACCTTAATACGC -> ATTGCGACCTTAATACGCT
GTACTTGGACGTTCACGGG -> TACTTGGACGTTCACGGGT
AGGAATCGAGACGGTCAGG -> GGAATCGAGACGGTCAGGC
ATGCTGAGTCGTCAGCCGC -> TGCTGAGTCGTCAGCCGCG
AGGGTTTCACACCTATTCC -> GGGTTTCACACCTATTCCG
GACTGAACCGGGGATAGCC -> ACTGAACCGGGGATAGCCA
ATTGAATTTTGCATGTTCC -> TTGAATTTTGCATGTTCCC
CTTCCTCGTAGTGGATATT -> TTCCTCGTAGTGGATATTA
AGAGGGGAGTCCGGCGGGA -> GAGGGGAGTCCGGCGGGAA
TCGGGGAGCAGGAATCGAG -> CGGGGAGCAGGAATCGAGA
ACCAGGCTGTATATTGCGA -> CCAGGCTGTATATTGCGAC
GCGTACAGCTGGGCTTATG -> CGTACAGCTGGGCTTATGC
CTCCTCGATAACGATGCGG -> TCCTCGATAACGATGCGGC
TTCTGGGCAGAGCTGGTCG -> TCTGGGCAGAGCTGGTCGC
CGTATCTAACCGGACAACT -> GTATCTAACCGGACAACTA
ATGAAGTACTTGGACGTTC -> TGAAGTACTTGGACGTTCA
GTTATGTCACATGGCCGTT -> TTATGTCACATGGCCGTTT
TCGTACATGCATCCTACCC -> CGTACATGCATCCTACCCT
AAGACTAGGAACACCACTG -> AGACTAGGAACACCACTGG
GCGGCTTGACATAAACACG -> CGGCTTGACATAAACACGT
GGATAGCCATCGTCCCCGC -> GATAGCCATCGTCCCCGCA
ATCGACCTTCCTATGCATG -> TCGACCTTCCTATGCATGG
CCTCCCACTCTTCGCTGAC -> CTCCCACTCTTCGCTGACT
ATGCATCCTACCCTCCGGT -> TGCATCCTACCCTCCGGTG
CTAGGCTTCCTCGTAGTGG -> TAGGCTTCCTCGTAGTGGA
CTAAGAACACGTGTCGTAA -> TAAGAACACGTGTCGTAAA
CCTCGTCCGACTCGTCCTC -> CTCGTCCGACTCGTCCTCC
AGCCTGTTGTACAATTGCC -> GCCTGTTGTACAATTGCCT
TCCACCAGGCTGTATATTG -> CCACCAGGCTGTATATTGC
GGCATCAAAGCTGGGGCCT -> GCATCAAAGCTGGGGCCTC
TCCCCGCACCTTCCTATGC -> CCCCGCACCTTCCTATGCA
CGTTTGTCCGTACATGTTG -> GTTTGTCCGTACATGTTGG
ACGGATCCCATACGGCCAA -> CGGATCCCATACGGCCAAA
CGTAGTGGATATTAAGCGC -> GTAGTGGATATTAAGCGCA
GCCCTCGTCCGACTCGTCC -> CCCTCGTCCGACTCGTCCT
GTTAGTCGGTGGTAGAAAT -> TTAGTCGGTGGTAGAAATA
GATACTAAGGGTGCATATG -> ATACTAAGGGTGCATATGT
GATAGCCATCGTCCCCGCA -> ATAGCCATCGTCCCCGCAT
GTCAGGAATGACCACTATT -> TCAGGAATGACCACTATTT
GTGAATTGCGCGCATGCCG -> TGAATTGCGCGCATGCCGC
ACGTGACGCCGTACCACCG -> CGTGACGCCGTACCACCGT
CATTATAATATCGACCTTC -> ATTATAATATCGACCTTCC
GACGGTCAGGCGGTTCAAA -> ACGGTCAGGCGGTTCAAAA
AGCAGGAATCGAGACGGTC -> GCAGGAATCGAGACGGTCA
GCTTGCCCTAGTCCCCCCC -> CTTGCCCTAGTCCCCCCCA
TAACGATGCGGCCGCATAC -> AACGATGCGGCCGCATACG
TGCCCTCGTCCGACTCGTC -> GCCCTCGTCCGACTCGTCC
ATTTTGCATGTTCCCCTCG -> TTTTGCATGTTCCCCTCGG
GTACCACCGTCCGATCACA -> TACCACCGTCCGATCACAT
AACAATGGGCAGTGCTAGA -> ACAATGGGCAGTGCTAGAG
TTGTGGCATCTTGCGATAC -> TGTGGCATCTTGCGATACG
CTATTTTACCGGTTATCTA -> TATTTTACCGGTTATCTAC
CCGCGCTGTTTACTCCAGC -> CGCGCTGTTTACTCCAGCA
CCGTGTTAGCTCACGGCAA -> CGTGTTAGCTCACGGCAAA
CCTACCCTCCGGTGCCAAT -> CTACCCTCCGGTGCCAATG
CCCGATGCTGGACGAAAGT -> CCGATGCTGGACGAAAGTC
CGGAGGGTTTCACACCTAT -> GGAGGGTTTCACACCTATT
AGAGCCTGTTGTACAATTG -> GAGCCTGTTGTACAATTGC
TTGCGATCTAAGAACACGT -> TGCGATCTAAGAACACGTG
TCAGGCGGTTCAAAAACAA -> CAGGCGGTTCAAAAACAAT
GAGGGTTTCACACCTATTC -> AGGGTTTCACACCTATTCC
TTATATAGACGCATAGCAA -> TATATAGACGCATAGCAAT
CACTGCAAGTTAGGTAGCT -> ACTGCAAGTTAGGTAGCTT
TTTTGTTCCTAACCGTTTG -> TTTGTTCCTAACCGTTTGT
TGTTATCAGCGGAGGTTGC -> GTTATCAGCGGAGGTTGCG
ACTGAACCGGGGATAGCCA -> CTGAACCGGGGATAGCCAT
CGACCTTCCTATGCATGGA -> GACCTTCCTATGCATGGAA
TGAATTTTGCATGTTCCCC -> GAATTTTGCATGTTCCCCT
GGTCGCCCAGAGCCAAGCC -> GTCGCCCAGAGCCAAGCCT
AGCGGAGGTTGCGACCCAC -> GCGGAGGTTGCGACCCACT
GACGCATAGCAATCTTACA -> ACGCATAGCAATCTTACAA
ACATGACCGGATGTGAAAA -> CATGACCGGATGTGAAAAT
TAGGTTATTGTCCATGGCG -> AGGTTATTGTCCATGGCGC
CATGGCCGTTTTAACCGCA -> ATGGCCGTTTTAACCGCAA
TCCCACTCTTCGCTGACTA -> CCCACTCTTCGCTGACTAT
TTAATTCCAAGCTAGACCG -> TAATTCCAAGCTAGACCGC
AGCGAGACATAGCGGAGGG -> GCGAGACATAGCGGAGGGT
GGTCTGTGCTTAGAAACAC -> GTCTGTGCTTAGAAACACA
TTCCGCAGGACGAGTCTAG -> TCCGCAGGACGAGTCTAGG
GAGGGATACGACGAGTCCT -> AGGGATACGACGAGTCCTT
TGTCTTTGCGTATACGAGA -> GTCTTTGCGTATACGAGAG
AACTTGGTGACCGTGCGAT -> ACTTGGTGACCGTGCGATT
ATACGAGAGCGAGACATAG -> TACGAGAGCGAGACATAGC
TCAAAGCTGGGGCCTCCCA -> CAAAGCTGGGGCCTCCCAC
TAAGAACACGTGTCGTAAA -> AAGAACACGTGTCGTAAAA
AATTAATGCGTAGAAGTCT -> ATTAATGCGTAGAAGTCTT
TAGGAACACCACTGGATAT -> AGGAACACCACTGGATATC
AACCGGACAACTATGATAC -> ACCGGACAACTATGATACT
GAGACTGAACCGGGGATAG -> AGACTGAACCGGGGATAGC
ACCAGAGGGGAGTCCGGCG -> CCAGAGGGGAGTCCGGCGG
TGAGGGATACGACGAGTCC -> GAGGGATACGACGAGTCCT
ATTTGATTGAATTTTGCAT -> TTTGATTGAATTTTGCATG
CGTAAAACTCCTCGATAAC -> GTAAAACTCCTCGATAACG
CGCTTGCCCTAGTCCCCCC -> GCTTGCCCTAGTCCCCCCC
GTACTTGGACGTTCAGGCC -> TACTTGGACGTTCAGGCCT
CACCTTAACGCGTTCCAAT -> ACCTTAACGCGTTCCAATG
ATTGCGACCTTAATACGCT -> TTGCGACCTTAATACGCTA
CATATGTCTTTGCGTATAC -> ATATGTCTTTGCGTATACG
CGGAGGTTGCGACCCACTG -> GGAGGTTGCGACCCACTGA
ACCTACATGACCTTGAAGT -> CCTACATGACCTTGAAGTG
AGAACCGAATTCTGGGCAG -> GAACCGAATTCTGGGCAGA
TTGGCACGTATCTAACCGG -> TGGCACGTATCTAACCGGA
TGTTAGCTCACGGCAAATG -> GTTAGCTCACGGCAAATGC
TTCAAGATGACTGTCCCAC -> TCAAGATGACTGTCCCACA
GTGGCGGTGTATTAGTAGC -> TGGCGGTGTATTAGTAGCC
CCTCAATGTGTAGTTTTGC -> CTCAATGTGTAGTTTTGCG
GGGGCCCTGTGGGCTGGGG -> GGGCCCTGTGGGCTGGGGT
TTGTTAGTTCATCGCCAGA -> TGTTAGTTCATCGCCAGAG
AGCTCACGGCAAATGCCGC -> GCTCACGGCAAATGCCGCT
GCACCACGCCAATTGACAT -> CACCACGCCAATTGACATT
CCAATTGACATTAGACGAC -> CAATTGACATTAGACGACT
AACTATGATACTAAGGGTG -> ACTATGATACTAAGGGTGC
AATTTTGCATGTTCCCCTC -> ATTTTGCATGTTCCCCTCG
GAGTTATATAGACGCATAG -> AGTTATATAGACGCATAGC
ATACGAACTTTGATAGCTG -> TACGAACTTTGATAGCTGA
AATAGTGCCAGAGGTCTTC -> ATAGTGCCAGAGGTCTTCA
ACTACGGATCCCATACGGC -> CTACGGATCCCATACGGCC
GTATCTAACCGGACAACTA -> TATCTAACCGGACAACTAT
CAAGTTAGGTAGCTTATGA -> AAGTTAGGTAGCTTATGAT
CTGTTTACTCCAGCATAGA -> TGTTTACTCCAGCATAGAC
TTGTCCGTACATGTTGGGT -> TGTCCGTACATGTTGGGTA
TGCGACCTTAATACGCTAG -> GCGACCTTAATACGCTAGG
ACCACACTTACGCGACCGC -> CCACACTTACGCGACCGCA
GGAGAATCGGGTAACGACA -> GAGAATCGGGTAACGACAA
ATGGCTAAGAAGACTAGGA -> TGGCTAAGAAGACTAGGAA
CAACTATGATACTAAGGGT -> AACTATGATACTAAGGGTG
TCCTATGCATGGAAGGAGT -> CCTATGCATGGAAGGAGTA
GTACTTGGACGTTCAAGCA -> TACTTGGACGTTCAAGCAA
CACACCTATTCCGCAGGAC -> ACACCTATTCCGCAGGACG
ACCCCCGTGCTGCGCCCTG -> CCCCCGTGCTGCGCCCTGG
AATAAGAGAACTTGGTGAC -> ATAAGAGAACTTGGTGACC
TGTGTAGTTTTGCGTACAG -> GTGTAGTTTTGCGTACAGC
GTGGCATCTTGCGATACGC -> TGGCATCTTGCGATACGCG
GCAATCTTGGCACGTATCT -> CAATCTTGGCACGTATCTA
TGCATCCTACCCTCCGGTG -> GCATCCTACCCTCCGGTGC
ATCCTCAGAGTTAGGTTAT -> TCCTCAGAGTTAGGTTATT
TCAGTGATTAATAGTGCCA -> CAGTGATTAATAGTGCCAG
AGTGATCGGTGGCACTATG -> GTGATCGGTGGCACTATGG
TTAATACGCTAGGTTTTGT -> TAATACGCTAGGTTTTGTG
GCTTGACATAAACACGTGA -> CTTGACATAAACACGTGAC
AAGCCTCAATGTGTAGTTT -> AGCCTCAATGTGTAGTTTT
AATTGACATTAGACGACTC -> ATTGACATTAGACGACTCG
AGTCTCGCATACACGGGCA -> GTCTCGCATACACGGGCAT
CCTAGGGTACCGACGGTTA -> CTAGGGTACCGACGGTTAT
CAGTATGCTGAGTCGTCAG -> AGTATGCTGAGTCGTCAGC
GGGATAGCCATCGTCCCCG -> GGATAGCCATCGTCCCCGC
TACTTGGACGTTCAGGCCT -> ACTTGGACGTTCAGGCCTA
CATGCCGCGGCTTGACATA -> ATGCCGCGGCTTGACATAA
CCTCGGGGAGCAGGAATCG -> CTCGGGGAGCAGGAATCGA
CACTTGCTTTACCGTGATA -> ACTTGCTTTACCGTGATAG
CACGTATCTAACCGGACAA -> ACGTATCTAACCGGACAAC
GGATAACAGGCATCAAAGC -> GATAACAGGCATCAAAGCT
TTACTCCAGCATAGACTGT -> TACTCCAGCATAGACTGTG
TGTTCGTTAATTCCAAGCT -> GTTCGTTAATTCCAAGCTA
AATACCACACTAGAACCAC -> ATACCACACTAGAACCACA
TAGTTAGTCGGTGGTAGAA -> AGTTAGTCGGTGGTAGAAA
AATGTACCTACATGACCTT -> ATGTACCTACATGACCTTG
ACCACCGTCCGATCACATT -> CCACCGTCCGATCACATTC
GGCCTATGATGACCTTCCT -> GCCTATGATGACCTTCCTA
CTGTGGGCTGGGGTCTGTG -> TGTGGGCTGGGGTCTGTGC
ATAGCGGAGGGTTTCACAC -> TAGCGGAGGGTTTCACACC
CAAAAACAATGGGCAGTGC -> AAAAACAATGGGCAGTGCT
CCAGAGAAGATATTTGATT -> CAGAGAAGATATTTGATTG
CGATCACATTCCTCAGACA -> GATCACATTCCTCAGACAC
GTGACGCCGTACCACCGTC -> TGACGCCGTACCACCGTCC
CCCACACAGTATGCTGAGT -> CCACACAGTATGCTGAGTC
GGTCAATTAATGCGTAGAA -> GTCAATTAATGCGTAGAAG
CATGGAAGCCATCTTAATA -> ATGGAAGCCATCTTAATAT
CACACATTGCCTAGGTTTG -> ACACATTGCCTAGGTTTGT
TCTCGGGGTATAAGCGAAG -> CTCGGGGTATAAGCGAAGT
TGACCGTGCGATTAATGGG -> GACCGTGCGATTAATGGGG
GCGACCGCAACCGATTTCA -> CGACCGCAACCGATTTCAA
GTCTTCAATCGTACATGCA -> TCTTCAATCGTACATGCAT
TGGATTGCGATCTAAGAAC -> GGATTGCGATCTAAGAACA
ATTCCGCAGGACGAGTCTA -> TTCCGCAGGACGAGTCTAG
GAGGTCTTCAATCGTACAT -> AGGTCTTCAATCGTACATG
ACCGTGCGATTAATGGGGG -> CCGTGCGATTAATGGGGGC
TATGCATGGAAGTCATTTT -> ATGCATGGAAGTCATTTTC
TACCAGAGGGGAGTCCGGC -> ACCAGAGGGGAGTCCGGCG
GACGAGTCCTTCTGAAGAC -> ACGAGTCCTTCTGAAGACA
ACGCCGTACCACCGTCCGA -> CGCCGTACCACCGTCCGAT
CGTTTTAACCGCAAGCCAG -> GTTTTAACCGCAAGCCAGA
TAACCGCAAGCCAGAAGTA -> AACCGCAAGCCAGAAGTAC
CATAGCGGAGGGTTTCACA -> ATAGCGGAGGGTTTCACAC
CAGTGGCGGTGTATTAGTA -> AGTGGCGGTGTATTAGTAG
AGGATAACAGGCATCAAAG -> GGATAACAGGCATCAAAGC
GGGAGCAGGAATCGAGACG -> GGAGCAGGAATCGAGACGG
CTTGGACGTTCAGGCCTAT -> TTGGACGTTCAGGCCTATG
CGGAAGTACTTGGACGTTC -> GGAAGTACTTGGACGTTCA
GAAATACCACACTAGAACC -> AAATACCACACTAGAACCA
TAATTCCAAGCTAGACCGC -> AATTCCAAGCTAGACCGCT
TGTATATTGCGACCTTAAT -> GTATATTGCGACCTTAATA
CCACGCCAATTGACATTAG -> CACGCCAATTGACATTAGA
CTCACGGCAAATGCCGCTG -> TCACGGCAAATGCCGCTGG
GTCTTTGCGTATACGAGAG -> TCTTTGCGTATACGAGAGC
ACTAATGAGTCAGGAATGA -> CTAATGAGTCAGGAATGAC
ACATTGCCTAGGTTTGTGA -> CATTGCCTAGGTTTGTGAC
GATATCCTGGTTATGTCAC -> ATATCCTGGTTATGTCACA
AGTGTATTCGGCAGAATAA -> GTGTATTCGGCAGAATAAG
ACGAATCTATTAGAGCCTG -> CGAATCTATTAGAGCCTGT
TCTATTAGAGCCTGTTGTA -> CTATTAGAGCCTGTTGTAC
TTAATGCGTAGAAGTCTTC -> TAATGCGTAGAAGTCTTCC
ATCTAAGAACACGTGTCGT -> TCTAAGAACACGTGTCGTA
CAAGATGACTGTCCCACAC -> AAGATGACTGTCCCACACA
CGCAATCTTGGCACGTATC -> GCAATCTTGGCACGTATCT
ATAACGATGCGGCCGCATA -> TAACGATGCGGCCGCATAC
CCTTCTGAATTAAGGATAA -> CTTCTGAATTAAGGATAAC
ACTATGGCTAAGAAGACTA -> CTATGGCTAAGAAGACTAG
TGTACAATTGCCTAGGGTA -> GTACAATTGCCTAGGGTAC
TCTTGCGATACGCGGAGGG -> CTTGCGATACGCGGAGGGG
GTTCGTTAATTCCAAGCTA -> TTCGTTAATTCCAAGCTAG
TTCCACGCGTATGCCCTCG -> TCCACGCGTATGCCCTCGT
TAGAGCCTGTTGTACAATT -> AGAGCCTGTTGTACAATTG
GCATGGAAGGAGTAGTGAT -> CATGGAAGGAGTAGTGATC
CTGGGGCCTCCCACTCTTC -> TGGGGCCTCCCACTCTTCG
TCGGGGTATAAGCGAAGTA -> CGGGGTATAAGCGAAGTAC
GGCACTATGGCTAAGAAGA -> GCACTATGGCTAAGAAGAC
ATCCACTTGCTTTACCGTG -> TCCACTTGCTTTACCGTGA
TCCGGTGCCAATGTTCTAA -> CCGGTGCCAATGTTCTAAG
TGGTCGCCCAGAGCCAAGC -> GGTCGCCCAGAGCCAAGCC
TTTTGCATGTTCCCCTCGG -> TTTGCATGTTCCCCTCGGG
TGCCCTAGTCCCCCCCATC -> GCCCTAGTCCCCCCCATCA
CCAGAGCCAAGCCTCAATG -> CAGAGCCAAGCCTCAATGT
TTACCGGTTATCTACCTCA -> TACCGGTTATCTACCTCAG
GATAATCCCGAGACTGAAC -> ATAATCCCGAGACTGAACC
TGTCCCACACAGTATGCTG -> GTCCCACACAGTATGCTGA
GGCCCTGGGAGTAATACAT -> GCCCTGGGAGTAATACATG
CCCCGCATAGTTAGTCGGT -> CCCGCATAGTTAGTCGGTG
ATTCCTCAGACACCAGTGG -> TTCCTCAGACACCAGTGGC
GTACCAGAGGGGAGTCCGG -> TACCAGAGGGGAGTCCGGC
CTCGTAGTGGATATTAAGC -> TCGTAGTGGATATTAAGCG
AACCGGGGATAGCCATCGT -> ACCGGGGATAGCCATCGTC
GCGAGACATAGCGGAGGGT -> CGAGACATAGCGGAGGGTT
AGTTATATAGACGCATAGC -> GTTATATAGACGCATAGCA
GACTAGGAACACCACTGGA -> ACTAGGAACACCACTGGAT
CCACACTTACGCGACCGCA -> CACACTTACGCGACCGCAA
GAAGTACTTGGACGTTCAC -> AAGTACTTGGACGTTCACG
CTACATGACCTTGAAGTGA -> TACATGACCTTGAAGTGAC
CTTCCACGCGTATGCCCTC -> TTCCACGCGTATGCCCTCG
AAGCTTGACTTGTTCGTTA -> AGCTTGACTTGTTCGTTAA
GTGTCGTAAAACTCCTCGA -> TGTCGTAAAACTCCTCGAT
CTGGTCGCCCAGAGCCAAG -> TGGTCGCCCAGAGCCAAGC
CTAGGGTACCGACGGTTAT -> TAGGGTACCGACGGTTATC
CATTAGACGACTCGCCAGC -> ATTAGACGACTCGCCAGCA
GCTGGCGGTCAATTAATGC -> CTGGCGGTCAATTAATGCG
TGGACGTTCACGGGTCCCC -> GGACGTTCACGGGTCCCCG
ACTATCTCGGGGTATAAGC -> CTATCTCGGGGTATAAGCG
CTAGGAACACCACTGGATA -> TAGGAACACCACTGGATAT
CGCGGCTTGACATAAACAC -> GCGGCTTGACATAAACACG
TGTGTTCGCACCTACGCAG -> GTGTTCGCACCTACGCAGT
TCATTTTCGTGGTTAGCCC -> CATTTTCGTGGTTAGCCCG
CGTTCAAGCAATCTCGAAC -> GTTCAAGCAATCTCGAACC
TTCGGCAGAATAAGAGAAC -> TCGGCAGAATAAGAGAACT
ACTGGCCCTGGGAGTAATA -> CTGGCCCTGGGAGTAATAC
GACGTTCACGGGTCCCCGC -> ACGTTCACGGGTCCCCGCA
ATGACTGTCCCACACAGTA -> TGACTGTCCCACACAGTAT
GATCTACTACGGATCCCAT -> ATCTACTACGGATCCCATA
GTCCCACACAGTATGCTGA -> TCCCACACAGTATGCTGAG
TCCACTTGCTTTACCGTGA -> CCACTTGCTTTACCGTGAT
TTCACGGGTCCCCGCACCT -> TCACGGGTCCCCGCACCTT
GCTTGACTTGTTCGTTAAT -> CTTGACTTGTTCGTTAATT
GAATCTATTAGAGCCTGTT -> AATCTATTAGAGCCTGTTG
TCATCGCCAGAGAAGATAT -> CATCGCCAGAGAAGATATT
ACCGAATTCTGGGCAGAGC -> CCGAATTCTGGGCAGAGCT
TCCTATGCATGGAAGCCAT -> CCTATGCATGGAAGCCATC
TGACTGTCCCACACAGTAT -> GACTGTCCCACACAGTATG
GGATATTAAGCGCACCACG -> GATATTAAGCGCACCACGC
TTCGTGGTTAGCCCGATGC -> TCGTGGTTAGCCCGATGCT
TAGAACCGAATTCTGGGCA -> AGAACCGAATTCTGGGCAG
TCAGGCCTATGATGACCTT -> CAGGCCTATGATGACCTTC
GTTCATTATAATATCGACC -> TTCATTATAATATCGACCT
GACCTTCTGAATTAAGGAT -> ACCTTCTGAATTAAGGATA
CAATGTTCTAAGTCAGCAC -> AATGTTCTAAGTCAGCACG
CTATGCATGGAAGCATTCA -> TATGCATGGAAGCATTCAC
TCCTTCTGAAGACAGGACA -> CCTTCTGAAGACAGGACAC
TTCAGGCCTATGATGACCT -> TCAGGCCTATGATGACCTT
TGCATGTTCCCCTCGGGGA -> GCATGTTCCCCTCGGGGAG
CGGATCCCATACGGCCAAA -> GGATCCCATACGGCCAAAC
CCATGGCGCTTGCCCTAGT -> CATGGCGCTTGCCCTAGTC
CTAAGTCAGCACGAATCTA -> TAAGTCAGCACGAATCTAT
CCCAGAGCCAAGCCTCAAT -> CCAGAGCCAAGCCTCAATG
TGTTCTAAGTCAGCACGAA -> GTTCTAAGTCAGCACGAAT
CTAATGAGTCAGGAATGAC -> TAATGAGTCAGGAATGACC
GCGCCCTGGATATCCTGGT -> CGCCCTGGATATCCTGGTT
TGTGGGCTGGGGTCTGTGC -> GTGGGCTGGGGTCTGTGCT
ATACGCGGAGGGGTTTAAT -> TACGCGGAGGGGTTTAATT
CGCCGTACCACCGTCCGAT -> GCCGTACCACCGTCCGATC
AGCTAGACCGCTTGTTATC -> GCTAGACCGCTTGTTATCA
TTAATAGTGCCAGAGGTCT -> TAATAGTGCCAGAGGTCTT
CTTATGATCTACTACGGAT -> TTATGATCTACTACGGATC
GTACATGCATCCTACCCTC -> TACATGCATCCTACCCTCC
CAGAGGGGAGTCCGGCGGG -> AGAGGGGAGTCCGGCGGGA
AATGGGGGCCCTGTGGGCT -> ATGGGGGCCCTGTGGGCTG
CGACCCACTGAAGACAATA -> GACCCACTGAAGACAATAC
CATACACGGGCATGGATTG -> ATACACGGGCATGGATTGC
CCAGCATAGACTGTGTTCG -> CAGCATAGACTGTGTTCGC
AGCCATCTTAATATCTTGG -> GCCATCTTAATATCTTGGC
AGCCGCGCTGTTTACTCCA -> GCCGCGCTGTTTACTCCAG
CAGTGTATTCGGCAGAATA -> AGTGTATTCGGCAGAATAA
CTCGGGGTATAAGCGAAGT -> TCGGGGTATAAGCGAAGTA
TAACCGTTTGTCCGTACAT -> AACCGTTTGTCCGTACATG
CTTGACATAAACACGTGAC -> TTGACATAAACACGTGACG
TGGGAGTAATACATGACCG -> GGGAGTAATACATGACCGG
TTCATTATAATATCGACCT -> TCATTATAATATCGACCTT
ACAGTCCACCAGGCTGTAT -> CAGTCCACCAGGCTGTATA
ATTGCCTAGGGTACCGACG -> TTGCCTAGGGTACCGACGG
GTGCCAGAGGTCTTCAATC -> TGCCAGAGGTCTTCAATCG
GTCAATTAATGCGTAGAAG -> TCAATTAATGCGTAGAAGT
CACACAGTATGCTGAGTCG -> ACACAGTATGCTGAGTCGT
CCCTGTGGGCTGGGGTCTG -> CCTGTGGGCTGGGGTCTGT
TACAATTGCCTAGGGTACC -> ACAATTGCCTAGGGTACCG
TCTAAGAACACGTGTCGTA -> CTAAGAACACGTGTCGTAA
GCAGCTAAGCTTGACTTGT -> CAGCTAAGCTTGACTTGTT
TTGGCCACAGTCCACCAGG -> TGGCCACAGTCCACCAGGC
GGTTATCTACCTCAGTGAT -> GTTATCTACCTCAGTGATT
TTTGCGTATACGAGAGCGA -> TTGCGTATACGAGAGCGAG
CACCACGCCAATTGACATT -> ACCACGCCAATTGACATTA
TACAGCTGGGCTTATGCCT -> ACAGCTGGGCTTATGCCTT
GAGCAGGAATCGAGACGGT -> AGCAGGAATCGAGACGGTC
GTATAAGCGAAGTACTTGG -> TATAAGCGAAGTACTTGGA
GAAGTCATTTTCGTGGTTA -> AAGTCATTTTCGTGGTTAG
GAAGTACTTGGACGTTCAA -> AAGTACTTGGACGTTCAAG
ACTTGGACGTTCAGGCCTA -> CTTGGACGTTCAGGCCTAT
CGGTGGCACTATGGCTAAG -> GGTGGCACTATGGCTAAGA
CGCAGCTAAGCTTGACTTG -> GCAGCTAAGCTTGACTTGT
GCCATCGTCCCCGCATAGT -> CCATCGTCCCCGCATAGTT
ATGCGTAGAAGTCTTCCAC -> TGCGTAGAAGTCTTCCACG
CCACTTGCTTTACCGTGAT -> CACTTGCTTTACCGTGATA
CTATTACACCAAGCATGTC -> TATTACACCAAGCATGTCG
AAGGAGTAGTGATCGGTGG -> AGGAGTAGTGATCGGTGGC
GCGGTGTATTAGTAGCCAC -> CGGTGTATTAGTAGCCACC
CCGCTGGCGGTCAATTAAT -> CGCTGGCGGTCAATTAATG
CACCAGTGGCGGTGTATTA -> ACCAGTGGCGGTGTATTAG
TACTGGCCCTGGGAGTAAT -> ACTGGCCCTGGGAGTAATA
CAGCCGCGCTGTTTACTCC -> AGCCGCGCTGTTTACTCCA
TTAGACGACTCGCCAGCAA -> TAGACGACTCGCCAGCAAG
CTATGCATGGAAGGAGTAG -> TATGCATGGAAGGAGTAGT
GGTACTGGCCCTGGGAGTA -> GTACTGGCCCTGGGAGTAA
TCCTCGATAACGATGCGGC -> CCTCGATAACGATGCGGCC
CTCAGAGTTAGGTTATTGT -> TCAGAGTTAGGTTATTGTC
GTTTGTCCGTACATGTTGG -> TTTGTCCGTACATGTTGGG
AGAATCGGGTAACGACAAT -> GAATCGGGTAACGACAATT
CGATGCGGCCGCATACGAA -> GATGCGGCCGCATACGAAC
TCAGGAATGACCACTATTT -> CAGGAATGACCACTATTTT
CCTCGATAACGATGCGGCC -> CTCGATAACGATGCGGCCG
ACGTATCTAACCGGACAAC -> CGTATCTAACCGGACAACT
CTAAGCTTGACTTGTTCGT -> TAAGCTTGACTTGTTCGTT
CCGTACATGTTGGGTACCA -> CGTACATGTTGGGTACCAG
ATAGCCATCGTCCCCGCAT -> TAGCCATCGTCCCCGCATA
CGCAACCGATTTCAAGATG -> GCAACCGATTTCAAGATGA
CCACTCTTCGCTGACTATC -> CACTCTTCGCTGACTATCT
CAGTGATTAATAGTGCCAG -> AGTGATTAATAGTGCCAGA
GGAAGTCATTTTCGTGGTT -> GAAGTCATTTTCGTGGTTA
GATGCGGCCGCATACGAAC -> ATGCGGCCGCATACGAACT
CCGAATTCTGGGCAGAGCT -> CGAATTCTGGGCAGAGCTG
GGAACTCAAGTGAGTCAGA -> GAACTCAAGTGAGTCAGAC
AATTCCAAGCTAGACCGCT -> ATTCCAAGCTAGACCGCTT
TGTGCTTAGAAACACACCC -> GTGCTTAGAAACACACCCC
GGACGAGTCTAGGCTTCCT -> GACGAGTCTAGGCTTCCTC
GCGGTTCAAAAACAATGGG -> CGGTTCAAAAACAATGGGC
TTGACATAAACACGTGACG -> TGACATAAACACGTGACGC
GGTCTTCAATCGTACATGC -> GTCTTCAATCGTACATGCA
GGCTTATGCCTTTACGTGT -> GCTTATGCCTTTACGTGTG
GGAACACCACTGGATATCT -> GAACACCACTGGATATCTA
CACCAGGCTGTATATTGCG -> ACCAGGCTGTATATTGCGA
TGTAGTTTTGCGTACAGCT -> GTAGTTTTGCGTACAGCTG
TGACGCCGTACCACCGTCC -> GACGCCGTACCACCGTCCG
CGCGCTGTTTACTCCAGCA -> GCGCTGTTTACTCCAGCAT
GTTCAGGCCTATGATGACC -> TTCAGGCCTATGATGACCT
AGACTGAACCGGGGATAGC -> GACTGAACCGGGGATAGCC
GAGCTGGTCGCCCAGAGCC -> AGCTGGTCGCCCAGAGCCA
TATTACACCAAGCATGTCG -> ATTACACCAAGCATGTCGC
GTTCGCACCTACGCAGTGT -> TTCGCACCTACGCAGTGTT
ACGAGAGCGAGACATAGCG -> CGAGAGCGAGACATAGCGG
CAATCTCGAACCTTCCTAT -> AATCTCGAACCTTCCTATG
CGAACCTTCCTATGCATGG -> GAACCTTCCTATGCATGGA
ATTTTCGTGGTTAGCCCGA -> TTTTCGTGGTTAGCCCGAT
GCCGTACCACCGTCCGATC -> CCGTACCACCGTCCGATCA
TGAAGACAATACTCGGGTA -> GAAGACAATACTCGGGTAC
AAGAAGACTAGGAACACCA -> AGAAGACTAGGAACACCAC
ATCTTGCGATACGCGGAGG -> TCTTGCGATACGCGGAGGG
TGAAGACAGGACACGATTC -> GAAGACAGGACACGATTCT
GGTTAGCCCGATGCTGGAC -> GTTAGCCCGATGCTGGACG
GCGACCCACTGAAGACAAT -> CGACCCACTGAAGACAATA
AAGGTAGCGCGCCGCAGCT -> AGGTAGCGCGCCGCAGCTA
TCGTCCCCGCATAGTTAGT -> CGTCCCCGCATAGTTAGTC
AAGTACTTGGACGTTCATT -> AGTACTTGGACGTTCATTA
ATCTACTACGGATCCCATA -> TCTACTACGGATCCCATAC
TTGCGATACGCGGAGGGGT -> TGCGATACGCGGAGGGGTT
CTACTAAAGGTAGCGCGCC -> TACTAAAGGTAGCGCGCCG
ATGTTCTAAGTCAGCACGA -> TGTTCTAAGTCAGCACGAA
GTTCCAGTTTCGTCGGGGC -> TTCCAGTTTCGTCGGGGCG
GCATATGTCTTTGCGTATA -> CATATGTCTTTGCGTATAC
TGCATGGAAGCCATCTTAA -> GCATGGAAGCCATCTTAAT
CTATGATACTAAGGGTGCA -> TATGATACTAAGGGTGCAT
TCGGTGGTAGAAATACCAC -> CGGTGGTAGAAATACCACA
AGTTTCGTCGGGGCGCAGT -> GTTTCGTCGGGGCGCAGTG
TATTCCGCAGGACGAGTCT -> ATTCCGCAGGACGAGTCTA
GATATCTAAAAACCCAAAT -> ATATCTAAAAACCCAAATC
ACTCCTCGATAACGATGCG -> CTCCTCGATAACGATGCGG
GTGCATATGTCTTTGCGTA -> TGCATATGTCTTTGCGTAT
ACTAGAACCACACTTACGC -> CTAGAACCACACTTACGCG
ACGCAGTGTTCCAGTTTCG -> CGCAGTGTTCCAGTTTCGT
CAGCACGAATCTATTAGAG -> AGCACGAATCTATTAGAGC
GCTTATGCCTTTACGTGTG -> CTTATGCCTTTACGTGTGC
GACCGCAACCGATTTCAAG -> ACCGCAACCGATTTCAAGA
CGAATTCTGGGCAGAGCTG -> GAATTCTGGGCAGAGCTGG
AGTGCTAGAGTTATATAGA -> GTGCTAGAGTTATATAGAC
AACTCAAGTGAGTCAGACC -> ACTCAAGTGAGTCAGACCT
CTATGATGACCTTCCTATG -> TATGATGACCTTCCTATGC
TATGTCTTTGCGTATACGA -> ATGTCTTTGCGTATACGAG
ACGACTCGCCAGCAAGACA -> CGACTCGCCAGCAAGACAC
ATGCATGGAAGTCATTTTC -> TGCATGGAAGTCATTTTCG
GGCATCTTGCGATACGCGG -> GCATCTTGCGATACGCGGA
CGGGTACTGGCCCTGGGAG -> GGGTACTGGCCCTGGGAGT
ATGACCTTCCTATGCATGG -> TGACCTTCCTATGCATGGA
CCTACCCCCGTGCTGCGCC -> CTACCCCCGTGCTGCGCCC
CTGGATATCCTGGTTATGT -> TGGATATCCTGGTTATGTC
AGCACGAATCTATTAGAGC -> GCACGAATCTATTAGAGCC
CTGGATATCTAAAAACCCA -> TGGATATCTAAAAACCCAA
GCATGGAAGCCATCTTAAT -> CATGGAAGCCATCTTAATA
GTGTAGTTTTGCGTACAGC -> TGTAGTTTTGCGTACAGCT
GCTGTTTACTCCAGCATAG -> CTGTTTACTCCAGCATAGA
TTGACTTGTTCGTTAATTC -> TGACTTGTTCGTTAATTCC
GAGTCGTCAGCCGCGCTGT -> AGTCGTCAGCCGCGCTGTT
AACAGGCATCAAAGCTGGG -> ACAGGCATCAAAGCTGGGG
ATGGGCAGTGCTAGAGTTA -> TGGGCAGTGCTAGAGTTAT
TAATAGTGCCAGAGGTCTT -> AATAGTGCCAGAGGTCTTC
ACGGGTCCCCGCACCTTCC -> CGGGTCCCCGCACCTTCCT
AACCTTCCTATGCATGGAA -> ACCTTCCTATGCATGGAAG
GCGCGCATGCCGCGGCTTG -> CGCGCATGCCGCGGCTTGA
ATCGTCCCCGCATAGTTAG -> TCGTCCCCGCATAGTTAGT
TTGCGTACAGCTGGGCTTA -> TGCGTACAGCTGGGCTTAT
CGATAACGATGCGGCCGCA -> GATAACGATGCGGCCGCAT
TCGGGGCGCAGTGTATTCG -> CGGGGCGCAGTGTATTCGG
AGGACACGATTCTTGTATT -> GGACACGATTCTTGTATTT
CTAACCGTTTGTCCGTACA -> TAACCGTTTGTCCGTACAT
ACTAAGGGTGCATATGTCT -> CTAAGGGTGCATATGTCTT
TCCTATGCATGGAAGCATT -> CCTATGCATGGAAGCATTC
TGGTGACCGTGCGATTAAT -> GGTGACCGTGCGATTAATG
TGTATTAGTAGCCACCTTA -> GTATTAGTAGCCACCTTAA
ACACGGGCATGGATTGCGA -> CACGGGCATGGATTGCGAT
GTTGCGACCCACTGAAGAC -> TTGCGACCCACTGAAGACA
AGGTAGCGCGCCGCAGCTA -> GGTAGCGCGCCGCAGCTAA
CCCCCCCATCAGGGTGGCG -> CCCCCCATCAGGGTGGCGT
CTGGGAGTAATACATGACC -> TGGGAGTAATACATGACCG
GAGTCCTTCTGAAGACAGG -> AGTCCTTCTGAAGACAGGA
TTGGACGTTCAGGCCTATG -> TGGACGTTCAGGCCTATGA
TGCGTATACGAGAGCGAGA -> GCGTATACGAGAGCGAGAC
AGTAATACATGACCGGATG -> GTAATACATGACCGGATGT
CAGAAGTACTTGGACGTTC -> AGAAGTACTTGGACGTTCA
ATCTATTAGAGCCTGTTGT -> TCTATTAGAGCCTGTTGTA
GGGTTTCACACCTATTCCG -> GGTTTCACACCTATTCCGC
GGGGATAGCCATCGTCCCC -> GGGATAGCCATCGTCCCCG
TAATACATGACCGGATGTG -> AATACATGACCGGATGTGA
GCGATACGCGGAGGGGTTT -> CGATACGCGGAGGGGTTTA
TCCTAACCGTTTGTCCGTA -> CCTAACCGTTTGTCCGTAC
CCGTTTTAACCGCAAGCCA -> CGTTTTAACCGCAAGCCAG
GGTACCGACGGTTATCTAT -> GTACCGACGGTTATCTATT
ATGGAAGCCATCTTAATAT -> TGGAAGCCATCTTAATATC
CCCATCCTCAGAGTTAGGT -> CCATCCTCAGAGTTAGGTT
CCTGGTTATGTCACATGGC -> CTGGTTATGTCACATGGCC
CTTCCTATGCATGGAAGCA -> TTCCTATGCATGGAAGCAT
CGGGGCGCAGTGTATTCGG -> GGGGCGCAGTGTATTCGGC
TACCACACTAGAACCACAC -> ACCACACTAGAACCACACT
AGATGACTGTCCCACACAG -> GATGACTGTCCCACACAGT
GAACTTGGTGACCGTGCGA -> AACTTGGTGACCGTGCGAT
GTGGTTAGCCCGATGCTGG -> TGGTTAGCCCGATGCTGGA
GTGACTACTAAAGGTAGCG -> TGACTACTAAAGGTAGCGC
GCAGGACGAGTCTAGGCTT -> CAGGACGAGTCTAGGCTTC
AACACCACTGGATATCTAA -> ACACCACTGGATATCTAAA
TCACATTCCTCAGACACCA -> CACATTCCTCAGACACCAG
ATGTGAAAATGTACCTACA -> TGTGAAAATGTACCTACAT
CGTACCACCGTCCGATCAC -> GTACCACCGTCCGATCACA
CTTCTGAATTAAGGATAAC -> TTCTGAATTAAGGATAACA
ATGACCACTATTTTACCGG -> TGACCACTATTTTACCGGT
TGTCCGTACATGTTGGGTA -> GTCCGTACATGTTGGGTAC
CGCATACGAACTTTGATAG -> GCATACGAACTTTGATAGC
GGCTTCCTCGTAGTGGATA -> GCTTCCTCGTAGTGGATAT
TCGCATACACGGGCATGGA -> CGCATACACGGGCATGGAT
ACGAAAGTCTCGCATACAC -> CGAAAGTCTCGCATACACG
CCACAGTCCACCAGGCTGT -> CACAGTCCACCAGGCTGTA
TTTTGTGGCATCTTGCGAT -> TTTGTGGCATCTTGCGATA
ACGTGTCGTAAAACTCCTC -> CGTGTCGTAAAACTCCTCG
CCAAGCTAGACCGCTTGTT -> CAAGCTAGACCGCTTGTTA
CATGACCTTGAAGTGACTA -> ATGACCTTGAAGTGACTAA
CCCACTCTTCGCTGACTAT -> CCACTCTTCGCTGACTATC
GTGGCACTATGGCTAAGAA -> TGGCACTATGGCTAAGAAG
CTGGGCAGAGCTGGTCGCC -> TGGGCAGAGCTGGTCGCCC
CCTCAGACACCAGTGGCGG -> CTCAGACACCAGTGGCGGT
ATTCGGCAGAATAAGAGAA -> TTCGGCAGAATAAGAGAAC
GTCTGTGCTTAGAAACACA -> TCTGTGCTTAGAAACACAC
GTCGCCCAGAGCCAAGCCT -> TCGCCCAGAGCCAAGCCTC
GTTATATAGACGCATAGCA -> TTATATAGACGCATAGCAA
GACTATCTCGGGGTATAAG -> ACTATCTCGGGGTATAAGC
ATTAAGCGCACCACGCCAA -> TTAAGCGCACCACGCCAAT
AGCCGTGTTAGCTCACGGC -> GCCGTGTTAGCTCACGGCA
AATATCGACCTTCCTATGC -> ATATCGACCTTCCTATGCA
ACGCGTTCCAATGCGCCCT -> CGCGTTCCAATGCGCCCTA
GGGAACTCAAGTGAGTCAG -> GGAACTCAAGTGAGTCAGA
TTACACCAAGCATGTCGCA -> TACACCAAGCATGTCGCAA
TACGCTAGGTTTTGTGGCA -> ACGCTAGGTTTTGTGGCAT
GCGTGGGAGAATCGGGTAA -> CGTGGGAGAATCGGGTAAC
CAAATCCACTTGCTTTACC -> AAATCCACTTGCTTTACCG
ATTAGTAGCCACCTTAACG -> TTAGTAGCCACCTTAACGC
ATTGCGATCTAAGAACACG -> TTGCGATCTAAGAACACGT
TAGCTTATGATCTACTACG -> AGCTTATGATCTACTACGG
CAATTTAGTGAATTGCGCG -> AATTTAGTGAATTGCGCGC
GACAATACTCGGGTACTGG -> ACAATACTCGGGTACTGGC
CCTTAATACGCTAGGTTTT -> CTTAATACGCTAGGTTTTG
GGCGGTGTATTAGTAGCCA -> GCGGTGTATTAGTAGCCAC
TCAATTAATGCGTAGAAGT -> CAATTAATGCGTAGAAGTC
AGGTTGCGACCCACTGAAG -> GGTTGCGACCCACTGAAGA
AGCGGAGGGTTTCACACCT -> GCGGAGGGTTTCACACCTA
CAATCTTACAATAGAACCG -> AATCTTACAATAGAACCGA
GTAGAAGTCTTCCACGCGT -> TAGAAGTCTTCCACGCGTA
TCTAACCGGACAACTATGA -> CTAACCGGACAACTATGAT
CGCATAGCAATCTTACAAT -> GCATAGCAATCTTACAATA
GTGATCGGTGGCACTATGG -> TGATCGGTGGCACTATGGC
GGGGAGCAGGAATCGAGAC -> GGGAGCAGGAATCGAGACG
CGCTAGGTTTTGTGGCATC -> GCTAGGTTTTGTGGCATCT
ATGGCGCTTGCCCTAGTCC -> TGGCGCTTGCCCTAGTCCC
ACACTTACGCGACCGCAAC -> CACTTACGCGACCGCAACC
CCAGAAGTACTTGGACGTT -> CAGAAGTACTTGGACGTTC
GGGCTGGGGTCTGTGCTTA -> GGCTGGGGTCTGTGCTTAG
GCAGAGCTGGTCGCCCAGA -> CAGAGCTGGTCGCCCAGAG
AAGCCATCTTAATATCTTG -> AGCCATCTTAATATCTTGG
GTGCGGAAGTACTTGGACG -> TGCGGAAGTACTTGGACGT
GACGTTCAGGCCTATGATG -> ACGTTCAGGCCTATGATGA
TCGCCCAGAGCCAAGCCTC -> CGCCCAGAGCCAAGCCTCA
TATGATCTACTACGGATCC -> ATGATCTACTACGGATCCC
CACCACTGGATATCTAAAA -> ACCACTGGATATCTAAAAA
CACATTCCTCAGACACCAG -> ACATTCCTCAGACACCAGT
CTGTCCCACACAGTATGCT -> TGTCCCACACAGTATGCTG
TAGTTTTGCGTACAGCTGG -> AGTTTTGCGTACAGCTGGG
CCTTCCTATGCATGGAAGT -> CTTCCTATGCATGGAAGTC
CCCCCGTGCTGCGCCCTGG -> CCCCGTGCTGCGCCCTGGA
CATACGAACTTTGATAGCT -> ATACGAACTTTGATAGCTG
CGCGCCGCAGCTAAGCTTG -> GCGCCGCAGCTAAGCTTGA
TTTCGTGGTTAGCCCGATG -> TTCGTGGTTAGCCCGATGC
GGGGAGTCCGGCGGGAACT -> GGGAGTCCGGCGGGAACTC
AGTGTTCCAGTTTCGTCGG -> GTGTTCCAGTTTCGTCGGG
ATAAACACGTGACGCCGTA -> TAAACACGTGACGCCGTAC
CCTATGCATGGAAGGAGTA -> CTATGCATGGAAGGAGTAG
ACTGTCCCACACAGTATGC -> CTGTCCCACACAGTATGCT
GCTGGGGCCTCCCACTCTT -> CTGGGGCCTCCCACTCTTC
GACTACTAAAGGTAGCGCG -> ACTACTAAAGGTAGCGCGC
AGCTGGGGCCTCCCACTCT -> GCTGGGGCCTCCCACTCTT
ACCACACTAGAACCACACT -> CCACACTAGAACCACACTT
AGAGGTCTTCAATCGTACA -> GAGGTCTTCAATCGTACAT
CAGACCTTCTGAATTAAGG -> AGACCTTCTGAATTAAGGA
TAGAAATACCACACTAGAA -> AGAAATACCACACTAGAAC
GGCTGTATATTGCGACCTT -> GCTGTATATTGCGACCTTA
GACCGTGCGATTAATGGGG -> ACCGTGCGATTAATGGGGG
TGAGTCGTCAGCCGCGCTG -> GAGTCGTCAGCCGCGCTGT
CAATGGGCAGTGCTAGAGT -> AATGGGCAGTGCTAGAGTT
CCCATACGGCCAAACCGAT -> CCATACGGCCAAACCGATA
CAAGCCAGAAGTACTTGGA -> AAGCCAGAAGTACTTGGAC
GATTTCAAGATGACTGTCC -> ATTTCAAGATGACTGTCCC
TAGCCATCGTCCCCGCATA -> AGCCATCGTCCCCGCATAG
AGGGTGGCGTGGGAGAATC -> GGGTGGCGTGGGAGAATCG
TTGTTCGTTAATTCCAAGC -> TGTTCGTTAATTCCAAGCT
TGGGTACCAGAGGGGAGTC -> GGGTACCAGAGGGGAGTCC
TCCCCGCATAGTTAGTCGG -> CCCCGCATAGTTAGTCGGT
CTAGGTTTTGTGGCATCTT -> TAGGTTTTGTGGCATCTTG
AATGGGCAGTGCTAGAGTT -> ATGGGCAGTGCTAGAGTTA
GACCTTGAAGTGACTAATG -> ACCTTGAAGTGACTAATGA
TGAAAATGTACCTACATGA -> GAAAATGTACCTACATGAC
TCCTACCCTCCGGTGCCAA -> CCTACCCTCCGGTGCCAAT
AGTGACTAATGAGTCAGGA -> GTGACTAATGAGTCAGGAA
GGCCGCATACGAACTTTGA -> GCCGCATACGAACTTTGAT
GCATAGACTGTGTTCGCAC -> CATAGACTGTGTTCGCACC
TTGACATTAGACGACTCGC -> TGACATTAGACGACTCGCC
TGGAAGCCATCTTAATATC -> GGAAGCCATCTTAATATCT
GCGTAGAAGTCTTCCACGC -> CGTAGAAGTCTTCCACGCG
ATCACATTCCTCAGACACC -> TCACATTCCTCAGACACCA
AAAGGTAGCGCGCCGCAGC -> AAGGTAGCGCGCCGCAGCT
ACTTGTTCGTTAATTCCAA -> CTTGTTCGTTAATTCCAAG
GAAGGAGTAGTGATCGGTG -> AAGGAGTAGTGATCGGTGG
GATGTGAAAATGTACCTAC -> ATGTGAAAATGTACCTACA
CTCCCACTCTTCGCTGACT -> TCCCACTCTTCGCTGACTA
TCCACGCGTATGCCCTCGT -> CCACGCGTATGCCCTCGTC
ATTAGAGCCTGTTGTACAA -> TTAGAGCCTGTTGTACAAT
CTGTATATTGCGACCTTAA -> TGTATATTGCGACCTTAAT
TATTGTCCATGGCGCTTGC -> ATTGTCCATGGCGCTTGCC
GACAATTTAGTGAATTGCG -> ACAATTTAGTGAATTGCGC
GCATAGCAATCTTACAATA -> CATAGCAATCTTACAATAG
ATCTAACCGGACAACTATG -> TCTAACCGGACAACTATGA
TTGATAGCTGAACAGAGCT -> TGATAGCTGAACAGAGCTG
CACGGCAAATGCCGCTGGC -> ACGGCAAATGCCGCTGGCG
CGCAGGACGAGTCTAGGCT -> GCAGGACGAGTCTAGGCTT
GCCTAGGTTTGTGACTACT -> CCTAGGTTTGTGACTACTA
CAGCAAGACACTGCAAGTT -> AGCAAGACACTGCAAGTTA
TTGCCTAGGGTACCGACGG -> TGCCTAGGGTACCGACGGT
TCACGGCAAATGCCGCTGG -> CACGGCAAATGCCGCTGGC
GTAGAAATACCACACTAGA -> TAGAAATACCACACTAGAA
TCGGCAGAATAAGAGAACT -> CGGCAGAATAAGAGAACTT
TAACGACAATTTAGTGAAT -> AACGACAATTTAGTGAATT
TACTCGGGTACTGGCCCTG -> ACTCGGGTACTGGCCCTGG
TGACCTTCCTATGCATGGA -> GACCTTCCTATGCATGGAA
GCGTTCCAATGCGCCCTAC -> CGTTCCAATGCGCCCTACC
CAGCATAGACTGTGTTCGC -> AGCATAGACTGTGTTCGCA
CAATACTCGGGTACTGGCC -> AATACTCGGGTACTGGCCC
GCCGCATACGAACTTTGAT -> CCGCATACGAACTTTGATA
TTTACGTGTGCGGAAGTAC -> TTACGTGTGCGGAAGTACT
TTCCTATGCATGGAAGGAG -> TCCTATGCATGGAAGGAGT
ACGCGGAGGGGTTTAATTG -> CGCGGAGGGGTTTAATTGT
TTCCAATGCGCCCTACCCC -> TCCAATGCGCCCTACCCCC
TAGAGTTATATAGACGCAT -> AGAGTTATATAGACGCATA
CCAGGCTGTATATTGCGAC -> CAGGCTGTATATTGCGACC
TCCCACACAGTATGCTGAG -> CCCACACAGTATGCTGAGT
TCCGACTCGTCCTCCTTTG -> CCGACTCGTCCTCCTTTGA
GTTCCAATGCGCCCTACCC -> TTCCAATGCGCCCTACCCC
GCCGCAGCTAAGCTTGACT -> CCGCAGCTAAGCTTGACTT
ACGGGCATGGATTGCGATC -> CGGGCATGGATTGCGATCT
CGCTTGTTATCAGCGGAGG -> GCTTGTTATCAGCGGAGGT
TAGTGATCGGTGGCACTAT -> AGTGATCGGTGGCACTATG
AGGGTACCGACGGTTATCT -> GGGTACCGACGGTTATCTA
TCGTCCTCCTTTGAGGGAT -> CGTCCTCCTTTGAGGGATA
ACTTGGACGTTCAAGCAAT -> CTTGGACGTTCAAGCAATC
GATCACATTCCTCAGACAC -> ATCACATTCCTCAGACACC
CGGTCAATTAATGCGTAGA -> GGTCAATTAATGCGTAGAA
TAGTTCATCGCCAGAGAAG -> AGTTCATCGCCAGAGAAGA
TTTTAACCGCAAGCCAGAA -> TTTAACCGCAAGCCAGAAG
TGGCTAAGAAGACTAGGAA -> GGCTAAGAAGACTAGGAAC
AGGGTGCATATGTCTTTGC -> GGGTGCATATGTCTTTGCG
TGTCACATGGCCGTTTTAA -> GTCACATGGCCGTTTTAAC
TCATGAAGTACTTGGACGT -> CATGAAGTACTTGGACGTT
GGGGCGCAGTGTATTCGGC -> GGGCGCAGTGTATTCGGCA
TGGATATTAAGCGCACCAC -> GGATATTAAGCGCACCACG
AGACGGTCAGGCGGTTCAA -> GACGGTCAGGCGGTTCAAA
CGACCGCAACCGATTTCAA -> GACCGCAACCGATTTCAAG
GCAAATGCCGCTGGCGGTC -> CAAATGCCGCTGGCGGTCA
TACGGCCAAACCGATAATC -> ACGGCCAAACCGATAATCC
GTGCCAATGTTCTAAGTCA -> TGCCAATGTTCTAAGTCAG
GCATGGATTGCGATCTAAG -> CATGGATTGCGATCTAAGA
TGAAGTGACTAATGAGTCA -> GAAGTGACTAATGAGTCAG
AAGTCTCGCATACACGGGC -> AGTCTCGCATACACGGGCA
CGCTGTTTACTCCAGCATA -> GCTGTTTACTCCAGCATAG
TCCCGAGACTGAACCGGGG -> CCCGAGACTGAACCGGGGA
CAGGCATCAAAGCTGGGGC -> AGGCATCAAAGCTGGGGCC
ACGTGTGCGGAAGTACTTG -> CGTGTGCGGAAGTACTTGG
CTCGATAACGATGCGGCCG -> TCGATAACGATGCGGCCGC
GAACTCAAGTGAGTCAGAC -> AACTCAAGTGAGTCAGACC
TTCCCCTCGGGGAGCAGGA -> TCCCCTCGGGGAGCAGGAA
TCTGAAGACAGGACACGAT -> CTGAAGACAGGACACGATT
CATGGCGCTTGCCCTAGTC -> ATGGCGCTTGCCCTAGTCC
AAGCATTCACACATTGCCT -> AGCATTCACACATTGCCTA
GGGTCCCCGCACCTTCCTA -> GGTCCCCGCACCTTCCTAT
TACCCCCGTGCTGCGCCCT -> ACCCCCGTGCTGCGCCCTG
TGTATTCGGCAGAATAAGA -> GTATTCGGCAGAATAAGAG
CCGGCGGGAACTCAAGTGA -> CGGCGGGAACTCAAGTGAG
CGTGCTGCGCCCTGGATAT -> GTGCTGCGCCCTGGATATC
ACCGGACAACTATGATACT -> CCGGACAACTATGATACTA
ATGTGTAGTTTTGCGTACA -> TGTGTAGTTTTGCGTACAG
GACAACTATGATACTAAGG -> ACAACTATGATACTAAGGG
GTAACGACAATTTAGTGAA -> TAACGACAATTTAGTGAAT
CTTGGACGTTCAAGCAATC -> TTGGACGTTCAAGCAATCT
AAGTGACTAATGAGTCAGG -> AGTGACTAATGAGTCAGGA
ATGTCGCAATCTTGGCACG -> TGTCGCAATCTTGGCACGT
AGAGAACTTGGTGACCGTG -> GAGAACTTGGTGACCGTGC
TGGGGTCTGTGCTTAGAAA -> GGGGTCTGTGCTTAGAAAC
CGTTCCAATGCGCCCTACC -> GTTCCAATGCGCCCTACCC
GTTTTAACCGCAAGCCAGA -> TTTTAACCGCAAGCCAGAA
TTCTGAAGACAGGACACGA -> TCTGAAGACAGGACACGAT
CCGCATAGTTAGTCGGTGG -> CGCATAGTTAGTCGGTGGT
TCTCGCATACACGGGCATG -> CTCGCATACACGGGCATGG
CTACCTCAGTGATTAATAG -> TACCTCAGTGATTAATAGT
ATCCCGAGACTGAACCGGG -> TCCCGAGACTGAACCGGGG
CACGAATCTATTAGAGCCT -> ACGAATCTATTAGAGCCTG
GTCATTTTCGTGGTTAGCC -> TCATTTTCGTGGTTAGCCC
CGTGTTAGCTCACGGCAAA -> GTGTTAGCTCACGGCAAAT
GCTAGAGTTATATAGACGC -> CTAGAGTTATATAGACGCA
CCCCGTGCTGCGCCCTGGA -> CCCGTGCTGCGCCCTGGAT
ACACGTGACGCCGTACCAC -> CACGTGACGCCGTACCACC
GCATTCACACATTGCCTAG -> CATTCACACATTGCCTAGG
ATGCTGGACGAAAGTCTCG -> TGCTGGACGAAAGTCTCGC
AATTCTGGGCAGAGCTGGT -> ATTCTGGGCAGAGCTGGTC
GGCGGTCAATTAATGCGTA -> GCGGTCAATTAATGCGTAG
GGGTGCATATGTCTTTGCG -> GGTGCATATGTCTTTGCGT
TTAGTCGGTGGTAGAAATA -> TAGTCGGTGGTAGAAATAC
AAACCGATAATCCCGAGAC -> AACCGATAATCCCGAGACT
TAGACGCATAGCAATCTTA -> AGACGCATAGCAATCTTAC
CGTACATGTTGGGTACCAG -> GTACATGTTGGGTACCAGA
TTCACACCTATTCCGCAGG -> TCACACCTATTCCGCAGGA
GACACGATTCTTGTATTTT -> ACACGATTCTTGTATTTTG
TGGCCCTGGGAGTAATACA -> GGCCCTGGGAGTAATACAT
TCCTTTGAGGGATACGACG -> CCTTTGAGGGATACGACGA
TGTTGGGTACCAGAGGGGA -> GTTGGGTACCAGAGGGGAG
GGGTAACGACAATTTAGTG -> GGTAACGACAATTTAGTGA
CAAGCCTCAATGTGTAGTT -> AAGCCTCAATGTGTAGTTT
CGGGGATAGCCATCGTCCC -> GGGGATAGCCATCGTCCCC
ATGCATGGAAGCATTCACA -> TGCATGGAAGCATTCACAC
CCTTTGAGGGATACGACGA -> CTTTGAGGGATACGACGAG
TCACACATTGCCTAGGTTT -> CACACATTGCCTAGGTTTG
GAAGTGACTAATGAGTCAG -> AAGTGACTAATGAGTCAGG
CGAAGTACTTGGACGTTCA -> GAAGTACTTGGACGTTCAC
GACCGCTTGTTATCAGCGG -> ACCGCTTGTTATCAGCGGA
ACCGCAAGCCAGAAGTACT -> CCGCAAGCCAGAAGTACTT
AACAGAGCTGAGCCGTGTT -> ACAGAGCTGAGCCGTGTTA
AATGCGTAGAAGTCTTCCA -> ATGCGTAGAAGTCTTCCAC
AGACCTTCTGAATTAAGGA -> GACCTTCTGAATTAAGGAT
TGTCCATGGCGCTTGCCCT -> GTCCATGGCGCTTGCCCTA
TGGATATCTAAAAACCCAA -> GGATATCTAAAAACCCAAA
GCAATCTCGAACCTTCCTA -> CAATCTCGAACCTTCCTAT
CATGCATCCTACCCTCCGG -> ATGCATCCTACCCTCCGGT
TATGCATGGAAGGAGTAGT -> ATGCATGGAAGGAGTAGTG
TGACTACTAAAGGTAGCGC -> GACTACTAAAGGTAGCGCG
GTAGCTTATGATCTACTAC -> TAGCTTATGATCTACTACG
GTATGCCCTCGTCCGACTC -> TATGCCCTCGTCCGACTCG
GACCGGATGTGAAAATGTA -> ACCGGATGTGAAAATGTAC
TGCTGCGCCCTGGATATCC -> GCTGCGCCCTGGATATCCT
TGGTTAGCCCGATGCTGGA -> GGTTAGCCCGATGCTGGAC
GTTTACTCCAGCATAGACT -> TTTACTCCAGCATAGACTG
TATCTCGGGGTATAAGCGA -> ATCTCGGGGTATAAGCGAA
GTCCGGCGGGAACTCAAGT -> TCCGGCGGGAACTCAAGTG
CTACTACGGATCCCATACG -> TACTACGGATCCCATACGG
ACATTAGACGACTCGCCAG -> CATTAGACGACTCGCCAGC
AGTCTTCCACGCGTATGCC -> GTCTTCCACGCGTATGCCC
ACCTACGCAGTGTTCCAGT -> CCTACGCAGTGTTCCAGTT
ACAATACTCGGGTACTGGC -> CAATACTCGGGTACTGGCC
CAATGTGTAGTTTTGCGTA -> AATGTGTAGTTTTGCGTAC
TTAATGGGGGCCCTGTGGG -> TAATGGGGGCCCTGTGGGC
TCTTCCACGCGTATGCCCT -> CTTCCACGCGTATGCCCTC
TCCTCAGAGTTAGGTTATT -> CCTCAGAGTTAGGTTATTG
TACTACGGATCCCATACGG -> ACTACGGATCCCATACGGC
GTTATCTATTACACCAAGC -> TTATCTATTACACCAAGCA
TGTGAAAATGTACCTACAT -> GTGAAAATGTACCTACATG
TCGTTAATTCCAAGCTAGA -> CGTTAATTCCAAGCTAGAC
TATCAGCGGAGGTTGCGAC -> ATCAGCGGAGGTTGCGACC
ATAATCCCGAGACTGAACC -> TAATCCCGAGACTGAACCG
CTTTGAGGGATACGACGAG -> TTTGAGGGATACGACGAGT
CTGTGCTTAGAAACACACC -> TGTGCTTAGAAACACACCC
AGCGCGCCGCAGCTAAGCT -> GCGCGCCGCAGCTAAGCTT
ATTAGACGACTCGCCAGCA -> TTAGACGACTCGCCAGCAA
TTTTACCGGTTATCTACCT -> TTTACCGGTTATCTACCTC
CCCCATCCTCAGAGTTAGG -> CCCATCCTCAGAGTTAGGT
CGAGAGCGAGACATAGCGG -> GAGAGCGAGACATAGCGGA
GCTTCCTCGTAGTGGATAT -> CTTCCTCGTAGTGGATATT
GGGAGTAATACATGACCGG -> GGAGTAATACATGACCGGA
GACCTTCCTATGCATGGAA -> ACCTTCCTATGCATGGAAG,ACCTTCCTATGCATGGAAG
GTGATTAATAGTGCCAGAG -> TGATTAATAGTGCCAGAGG
CATTCCTCAGACACCAGTG -> ATTCCTCAGACACCAGTGG
TTCCTAACCGTTTGTCCGT -> TCCTAACCGTTTGTCCGTA
TGGACGTTCAAGCAATCTC -> GGACGTTCAAGCAATCTCG
GGCCCTGTGGGCTGGGGTC -> GCCCTGTGGGCTGGGGTCT
ACTTGCTTTACCGTGATAG -> CTTGCTTTACCGTGATAGA
GCACGTATCTAACCGGACA -> CACGTATCTAACCGGACAA
AACCGCAAGCCAGAAGTAC -> ACCGCAAGCCAGAAGTACT
TCTTTGCGTATACGAGAGC -> CTTTGCGTATACGAGAGCG
CGACTCGCCAGCAAGACAC -> GACTCGCCAGCAAGACACT
GAGTAATACATGACCGGAT -> AGTAATACATGACCGGATG
GAATCGGGTAACGACAATT -> AATCGGGTAACGACAATTT
TTATAATATCGACCTTCCT -> TATAATATCGACCTTCCTA
GAGAAGATATTTGATTGAA -> AGAAGATATTTGATTGAAT
AGGTTATTGTCCATGGCGC -> GGTTATTGTCCATGGCGCT
ATGCCCTCGTCCGACTCGT -> TGCCCTCGTCCGACTCGTC
CGCGACCGCAACCGATTTC -> GCGACCGCAACCGATTTCA
TCAAGATGACTGTCCCACA -> CAAGATGACTGTCCCACAC
CTCGAACCTTCCTATGCAT -> TCGAACCTTCCTATGCATG
GCCCTAGTCCCCCCCATCA -> CCCTAGTCCCCCCCATCAG
CCGGGGATAGCCATCGTCC -> CGGGGATAGCCATCGTCCC
CTTATGCCTTTACGTGTGC -> TTATGCCTTTACGTGTGCG
TCAATCGTACATGCATCCT -> CAATCGTACATGCATCCTA
TGCATGGAAGCATTCACAC -> GCATGGAAGCATTCACACA
ACTGCAAGTTAGGTAGCTT -> CTGCAAGTTAGGTAGCTTA
GTATACGAGAGCGAGACAT -> TATACGAGAGCGAGACATA
AATTGCGCGCATGCCGCGG -> ATTGCGCGCATGCCGCGGC
CTGACTATCTCGGGGTATA -> TGACTATCTCGGGGTATAA
ATTTTACCGGTTATCTACC -> TTTTACCGGTTATCTACCT
GTTAGTTCATCGCCAGAGA -> TTAGTTCATCGCCAGAGAA
TATTTTGTTCCTAACCGTT -> ATTTTGTTCCTAACCGTTT
CCGAGACTGAACCGGGGAT -> CGAGACTGAACCGGGGATA
GGTGTATTAGTAGCCACCT -> GTGTATTAGTAGCCACCTT
CCTCAGAGTTAGGTTATTG -> CTCAGAGTTAGGTTATTGT
GTATATTGCGACCTTAATA -> TATATTGCGACCTTAATAC
CAGTCCACCAGGCTGTATA -> AGTCCACCAGGCTGTATAT
GAACCTTCCTATGCATGGA -> AACCTTCCTATGCATGGAA
GCGATTAATGGGGGCCCTG -> CGATTAATGGGGGCCCTGT
AGTATGCTGAGTCGTCAGC -> GTATGCTGAGTCGTCAGCC
GACGGTTATCTATTACACC -> ACGGTTATCTATTACACCA
TCCCCTCGGGGAGCAGGAA -> CCCCTCGGGGAGCAGGAAT
GGATATCCTGGTTATGTCA -> GATATCCTGGTTATGTCAC
AATGTTCTAAGTCAGCACG -> ATGTTCTAAGTCAGCACGA
TGTGCGGAAGTACTTGGAC -> GTGCGGAAGTACTTGGACG
TAAGCGAAGTACTTGGACG -> AAGCGAAGTACTTGGACGT
ACTGTGTTCGCACCTACGC -> CTGTGTTCGCACCTACGCA
GACTTGTTCGTTAATTCCA -> ACTTGTTCGTTAATTCCAA
GACGAAAGTCTCGCATACA -> ACGAAAGTCTCGCATACAC
ATACTCGGGTACTGGCCCT -> TACTCGGGTACTGGCCCTG
GACGCCGTACCACCGTCCG -> ACGCCGTACCACCGTCCGA
CAGGCGGTTCAAAAACAAT -> AGGCGGTTCAAAAACAATG
CCCGCATAGTTAGTCGGTG -> CCGCATAGTTAGTCGGTGG
GCAGTGCTAGAGTTATATA -> CAGTGCTAGAGTTATATAG
GAGTCTAGGCTTCCTCGTA -> AGTCTAGGCTTCCTCGTAG
TAATGAGTCAGGAATGACC -> AATGAGTCAGGAATGACCA
CGTCAGCCGCGCTGTTTAC -> GTCAGCCGCGCTGTTTACT
CGATAATCCCGAGACTGAA -> GATAATCCCGAGACTGAAC
GTGCTAGAGTTATATAGAC -> TGCTAGAGTTATATAGACG
GAAAATGTACCTACATGAC -> AAAATGTACCTACATGACC
GACTCGTCCTCCTTTGAGG -> ACTCGTCCTCCTTTGAGGG
GCATAGTTAGTCGGTGGTA -> CATAGTTAGTCGGTGGTAG
CGAGACATAGCGGAGGGTT -> GAGACATAGCGGAGGGTTT
GCTTATGATCTACTACGGA -> CTTATGATCTACTACGGAT
GCCCTACCCCCGTGCTGCG -> CCCTACCCCCGTGCTGCGC
TACAATAGAACCGAATTCT -> ACAATAGAACCGAATTCTG
GAAAGTCTCGCATACACGG -> AAAGTCTCGCATACACGGG
GGACACGATTCTTGTATTT -> GACACGATTCTTGTATTTT
AGGGATACGACGAGTCCTT -> GGGATACGACGAGTCCTTC
AATCGTACATGCATCCTAC -> ATCGTACATGCATCCTACC
CTCAAGTGAGTCAGACCTT -> TCAAGTGAGTCAGACCTTC
AACGACAATTTAGTGAATT -> ACGACAATTTAGTGAATTG
CTTGCTTTACCGTGATAGA -> TTGCTTTACCGTGATAGAA
TTCAAAAACAATGGGCAGT -> TCAAAAACAATGGGCAGTG
TGGCATCTTGCGATACGCG -> GGCATCTTGCGATACGCGG
TACATGACCTTGAAGTGAC -> ACATGACCTTGAAGTGACT
TTCGCTGACTATCTCGGGG -> TCGCTGACTATCTCGGGGT
CCTGGATATCCTGGTTATG -> CTGGATATCCTGGTTATGT
CACACTAGAACCACACTTA -> ACACTAGAACCACACTTAC
TATGCCCTCGTCCGACTCG -> ATGCCCTCGTCCGACTCGT
GCCAATGTTCTAAGTCAGC -> CCAATGTTCTAAGTCAGCA
CCGCAACCGATTTCAAGAT -> CGCAACCGATTTCAAGATG
GCTGGGGTCTGTGCTTAGA -> CTGGGGTCTGTGCTTAGAA
CAGGAATGACCACTATTTT -> AGGAATGACCACTATTTTA
AAACACACCCCATCCTCAG -> AACACACCCCATCCTCAGA
GGTAACGACAATTTAGTGA -> GTAACGACAATTTAGTGAA
AAGCTAGACCGCTTGTTAT -> AGCTAGACCGCTTGTTATC
AGACACTGCAAGTTAGGTA -> GACACTGCAAGTTAGGTAG
ACGGTCAGGCGGTTCAAAA -> CGGTCAGGCGGTTCAAAAA
AGCATGTCGCAATCTTGGC -> GCATGTCGCAATCTTGGCA
GAGCCAAGCCTCAATGTGT -> AGCCAAGCCTCAATGTGTA
GAGGTTGCGACCCACTGAA -> AGGTTGCGACCCACTGAAG
CTAAAAACCCAAATCCACT -> TAAAAACCCAAATCCACTT
CCAAGCCTCAATGTGTAGT -> CAAGCCTCAATGTGTAGTT
CGGCAAATGCCGCTGGCGG -> GGCAAATGCCGCTGGCGGT
CCGCAAGCCAGAAGTACTT -> CGCAAGCCAGAAGTACTTG
GCATCTTGCGATACGCGGA -> CATCTTGCGATACGCGGAG
GCCCTGGATATCCTGGTTA -> CCCTGGATATCCTGGTTAT
AGTGCCAGAGGTCTTCAAT -> GTGCCAGAGGTCTTCAATC
AATCCCGAGACTGAACCGG -> ATCCCGAGACTGAACCGGG
CAAGCAATCTCGAACCTTC -> AAGCAATCTCGAACCTTCC
TAGCCACCTTAACGCGTTC -> AGCCACCTTAACGCGTTCC
ACGCCAATTGACATTAGAC -> CGCCAATTGACATTAGACG
ATTAATAGTGCCAGAGGTC -> TTAATAGTGCCAGAGGTCT
CCCTCGTCCGACTCGTCCT -> CCTCGTCCGACTCGTCCTC
GGTCCCCGCACCTTCCTAT -> GTCCCCGCACCTTCCTATG
AGGAACACCACTGGATATC -> GGAACACCACTGGATATCT
TTGTTCCTAACCGTTTGTC -> TGTTCCTAACCGTTTGTCC
GGATCCCATACGGCCAAAC -> GATCCCATACGGCCAAACC
CACGGGCATGGATTGCGAT -> ACGGGCATGGATTGCGATC
CTGAAGACAGGACACGATT -> TGAAGACAGGACACGATTC
GCTGGACGAAAGTCTCGCA -> CTGGACGAAAGTCTCGCAT
ACCGCTTGTTATCAGCGGA -> CCGCTTGTTATCAGCGGAG
ATCAAAGCTGGGGCCTCCC -> TCAAAGCTGGGGCCTCCCA
TCGTCGGGGCGCAGTGTAT -> CGTCGGGGCGCAGTGTATT
CCAGAGGTCTTCAATCGTA -> CAGAGGTCTTCAATCGTAC
TGGGAGAATCGGGTAACGA -> GGGAGAATCGGGTAACGAC
CTAAGAAGACTAGGAACAC -> TAAGAAGACTAGGAACACC
GATTAATGGGGGCCCTGTG -> ATTAATGGGGGCCCTGTGG
AGTCGGTGGTAGAAATACC -> GTCGGTGGTAGAAATACCA
TTATGCCTTTACGTGTGCG -> TATGCCTTTACGTGTGCGG
GAATAAGAGAACTTGGTGA -> AATAAGAGAACTTGGTGAC
ACAATGGGCAGTGCTAGAG -> CAATGGGCAGTGCTAGAGT
ACATAGCGGAGGGTTTCAC -> CATAGCGGAGGGTTTCACA
GCTTGTTATCAGCGGAGGT -> CTTGTTATCAGCGGAGGTT
TCCATGGCGCTTGCCCTAG -> CCATGGCGCTTGCCCTAGT
ATACACGGGCATGGATTGC -> TACACGGGCATGGATTGCG
TAAAACTCCTCGATAACGA -> AAAACTCCTCGATAACGAT
GCGCCGCAGCTAAGCTTGA -> CGCCGCAGCTAAGCTTGAC
ACTCCAGCATAGACTGTGT -> CTCCAGCATAGACTGTGTT
AGAACCACACTTACGCGAC -> GAACCACACTTACGCGACC
CAGAGAAGATATTTGATTG -> AGAGAAGATATTTGATTGA
CTATTCCGCAGGACGAGTC -> TATTCCGCAGGACGAGTCT
GTGACTAATGAGTCAGGAA -> TGACTAATGAGTCAGGAAT
GCCAGAGGTCTTCAATCGT -> CCAGAGGTCTTCAATCGTA
TGACTAATGAGTCAGGAAT -> GACTAATGAGTCAGGAATG
ACACTGCAAGTTAGGTAGC -> CACTGCAAGTTAGGTAGCT
GTAGTGATCGGTGGCACTA -> TAGTGATCGGTGGCACTAT
TTCCAGTTTCGTCGGGGCG -> TCCAGTTTCGTCGGGGCGC
TGCGACCCACTGAAGACAA -> GCGACCCACTGAAGACAAT
ATTTAGTGAATTGCGCGCA -> TTTAGTGAATTGCGCGCAT
CTTCGCTGACTATCTCGGG -> TTCGCTGACTATCTCGGGG
ACACCAGTGGCGGTGTATT -> CACCAGTGGCGGTGTATTA
AATGACCACTATTTTACCG -> ATGACCACTATTTTACCGG
ATCTTACAATAGAACCGAA -> TCTTACAATAGAACCGAAT
TTATCTATTACACCAAGCA -> TATCTATTACACCAAGCAT
AAGAACACGTGTCGTAAAA -> AGAACACGTGTCGTAAAAC
AAGGATAACAGGCATCAAA -> AGGATAACAGGCATCAAAG
GGAATGACCACTATTTTAC -> GAATGACCACTATTTTACC
ACATTCCTCAGACACCAGT -> CATTCCTCAGACACCAGTG
GGTTCAAAAACAATGGGCA -> GTTCAAAAACAATGGGCAG
GGAAGTACTTGGACGTTCA -> GAAGTACTTGGACGTTCAG
CTTTGATAGCTGAACAGAG -> TTTGATAGCTGAACAGAGC
TAAGGGTGCATATGTCTTT -> AAGGGTGCATATGTCTTTG
TTCGTCGGGGCGCAGTGTA -> TCGTCGGGGCGCAGTGTAT
TCGTAAAACTCCTCGATAA -> CGTAAAACTCCTCGATAAC
ACTAGGAACACCACTGGAT -> CTAGGAACACCACTGGATA
GCAGTGTATTCGGCAGAAT -> CAGTGTATTCGGCAGAATA
TTGGTGACCGTGCGATTAA -> TGGTGACCGTGCGATTAAT
CCTTCTGAAGACAGGACAC -> CTTCTGAAGACAGGACACG
GAGTCAGGAATGACCACTA -> AGTCAGGAATGACCACTAT
AGTCAGGAATGACCACTAT -> GTCAGGAATGACCACTATT
AAGGGTGCATATGTCTTTG -> AGGGTGCATATGTCTTTGC
AATCTATTAGAGCCTGTTG -> ATCTATTAGAGCCTGTTGT
CATACGGCCAAACCGATAA -> ATACGGCCAAACCGATAAT
TCAGCACGAATCTATTAGA -> CAGCACGAATCTATTAGAG
TTGTCCATGGCGCTTGCCC -> TGTCCATGGCGCTTGCCCT
CGGGTAACGACAATTTAGT -> GGGTAACGACAATTTAGTG
AGGCATCAAAGCTGGGGCC -> GGCATCAAAGCTGGGGCCT
CACATGGCCGTTTTAACCG -> ACATGGCCGTTTTAACCGC
CATAGTTAGTCGGTGGTAG -> ATAGTTAGTCGGTGGTAGA
GCCTAGGGTACCGACGGTT -> CCTAGGGTACCGACGGTTA
GTTCTAAGTCAGCACGAAT -> TTCTAAGTCAGCACGAATC
TTAGCCCGATGCTGGACGA -> TAGCCCGATGCTGGACGAA
GCCGTTTTAACCGCAAGCC -> CCGTTTTAACCGCAAGCCA
ATACTAAGGGTGCATATGT -> TACTAAGGGTGCATATGTC
AGCCAAGCCTCAATGTGTA -> GCCAAGCCTCAATGTGTAG
AGCTGAACAGAGCTGAGCC -> GCTGAACAGAGCTGAGCCG
TAATCCCGAGACTGAACCG -> AATCCCGAGACTGAACCGG
TTTAGTGAATTGCGCGCAT -> TTAGTGAATTGCGCGCATG
CGCGGAGGGGTTTAATTGT -> GCGGAGGGGTTTAATTGTT
ACATGACCTTGAAGTGACT -> CATGACCTTGAAGTGACTA
GTTATTGTCCATGGCGCTT -> TTATTGTCCATGGCGCTTG
AGCTGGGCTTATGCCTTTA -> GCTGGGCTTATGCCTTTAC
GAGTCAGACCTTCTGAATT -> AGTCAGACCTTCTGAATTA
GCGCACCACGCCAATTGAC -> CGCACCACGCCAATTGACA
TCCGATCACATTCCTCAGA -> CCGATCACATTCCTCAGAC
AATTAAGGATAACAGGCAT -> ATTAAGGATAACAGGCATC
GTTTCACACCTATTCCGCA -> TTTCACACCTATTCCGCAG
CCTATGCATGGAAGTCATT -> CTATGCATGGAAGTCATTT
GAGCTGAGCCGTGTTAGCT -> AGCTGAGCCGTGTTAGCTC
GTGTATTAGTAGCCACCTT -> TGTATTAGTAGCCACCTTA
ATTGTCCATGGCGCTTGCC -> TTGTCCATGGCGCTTGCCC
GGCAGTGCTAGAGTTATAT -> GCAGTGCTAGAGTTATATA
TCCAGTTTCGTCGGGGCGC -> CCAGTTTCGTCGGGGCGCA
GAAGATATTTGATTGAATT -> AAGATATTTGATTGAATTT
ATATCCTGGTTATGTCACA -> TATCCTGGTTATGTCACAT
AGTACTTGGACGTTCAGGC -> GTACTTGGACGTTCAGGCC
TATTTGATTGAATTTTGCA -> ATTTGATTGAATTTTGCAT
CGGGAACTCAAGTGAGTCA -> GGGAACTCAAGTGAGTCAG
GCGCGCCGCAGCTAAGCTT -> CGCGCCGCAGCTAAGCTTG
CTCAGTGATTAATAGTGCC -> TCAGTGATTAATAGTGCCA
AAAGCTGGGGCCTCCCACT -> AAGCTGGGGCCTCCCACTC
GGGTTTAATTGTTAGTTCA -> GGTTTAATTGTTAGTTCAT
GAGCCTGTTGTACAATTGC -> AGCCTGTTGTACAATTGCC
ACCGTTTGTCCGTACATGT -> CCGTTTGTCCGTACATGTT
GTATTTTGTTCCTAACCGT -> TATTTTGTTCCTAACCGTT
CAGTTTCGTCGGGGCGCAG -> AGTTTCGTCGGGGCGCAGT
TCGGGTACTGGCCCTGGGA -> CGGGTACTGGCCCTGGGAG
CTACCCCCGTGCTGCGCCC -> TACCCCCGTGCTGCGCCCT
ACTATGATACTAAGGGTGC -> CTATGATACTAAGGGTGCA
TAATTGTTAGTTCATCGCC -> AATTGTTAGTTCATCGCCA
TGAATTAAGGATAACAGGC -> GAATTAAGGATAACAGGCA
AGGGGTTTAATTGTTAGTT -> GGGGTTTAATTGTTAGTTC
CGAAAGTCTCGCATACACG -> GAAAGTCTCGCATACACGG
TGGCGGTGTATTAGTAGCC -> GGCGGTGTATTAGTAGCCA
TGCTGAGTCGTCAGCCGCG -> GCTGAGTCGTCAGCCGCGC
GATTGAATTTTGCATGTTC -> ATTGAATTTTGCATGTTCC
CCCCATCAGGGTGGCGTGG -> CCCATCAGGGTGGCGTGGG
TCAAAAACAATGGGCAGTG -> CAAAAACAATGGGCAGTGC
TTTACTCCAGCATAGACTG -> TTACTCCAGCATAGACTGT
AAGATATTTGATTGAATTT -> AGATATTTGATTGAATTTT
AAGCTGGGGCCTCCCACTC -> AGCTGGGGCCTCCCACTCT
CCAGTGGCGGTGTATTAGT -> CAGTGGCGGTGTATTAGTA
ATTCTTGTATTTTGTTCCT -> TTCTTGTATTTTGTTCCTA
TTCATCGCCAGAGAAGATA -> TCATCGCCAGAGAAGATAT
CTAACCGGACAACTATGAT -> TAACCGGACAACTATGATA
AAATGCCGCTGGCGGTCAA -> AATGCCGCTGGCGGTCAAT
TATAAGCGAAGTACTTGGA -> ATAAGCGAAGTACTTGGAC
AGGTCTTCAATCGTACATG -> GGTCTTCAATCGTACATGC
TGACCACTATTTTACCGGT -> GACCACTATTTTACCGGTT
TACCACCGTCCGATCACAT -> ACCACCGTCCGATCACATT
ACCACGCCAATTGACATTA -> CCACGCCAATTGACATTAG
GTTCCTAACCGTTTGTCCG -> TTCCTAACCGTTTGTCCGT
TCAGCCGCGCTGTTTACTC -> CAGCCGCGCTGTTTACTCC
GATTGCGATCTAAGAACAC -> ATTGCGATCTAAGAACACG
GCCGCTGGCGGTCAATTAA -> CCGCTGGCGGTCAATTAAT
TGCTGGACGAAAGTCTCGC -> GCTGGACGAAAGTCTCGCA
TTAGTAGCCACCTTAACGC -> TAGTAGCCACCTTAACGCG
ACCTTAATACGCTAGGTTT -> CCTTAATACGCTAGGTTTT
GCCGTGTTAGCTCACGGCA -> CCGTGTTAGCTCACGGCAA
CGTATGCCCTCGTCCGACT -> GTATGCCCTCGTCCGACTC
CGAGTCCTTCTGAAGACAG -> GAGTCCTTCTGAAGACAGG
CGCTGGCGGTCAATTAATG -> GCTGGCGGTCAATTAATGC
TCGCCAGCAAGACACTGCA -> CGCCAGCAAGACACTGCAA
CAGAATAAGAGAACTTGGT -> AGAATAAGAGAACTTGGTG
GTGACCGTGCGATTAATGG -> TGACCGTGCGATTAATGGG
CGGCGGGAACTCAAGTGAG -> GGCGGGAACTCAAGTGAGT
GTCCACCAGGCTGTATATT -> TCCACCAGGCTGTATATTG
GGCCGTTTTAACCGCAAGC -> GCCGTTTTAACCGCAAGCC
GTCACATGGCCGTTTTAAC -> TCACATGGCCGTTTTAACC
TGACATAAACACGTGACGC -> GACATAAACACGTGACGCC
CTTCCTATGCATGGAAGCC -> TTCCTATGCATGGAAGCCA
AGAGTTAGGTTATTGTCCA -> GAGTTAGGTTATTGTCCAT
TAAAAACCCAAATCCACTT -> AAAAACCCAAATCCACTTG
AGAGCCAAGCCTCAATGTG -> GAGCCAAGCCTCAATGTGT
CTTGTTATCAGCGGAGGTT -> TTGTTATCAGCGGAGGTTG
AATGTGTAGTTTTGCGTAC -> ATGTGTAGTTTTGCGTACA
GGAAGGAGTAGTGATCGGT -> GAAGGAGTAGTGATCGGTG
CGGCAGAATAAGAGAACTT -> GGCAGAATAAGAGAACTTG
GCCAGAAGTACTTGGACGT -> CCAGAAGTACTTGGACGTT
GTCTAGGCTTCCTCGTAGT -> TCTAGGCTTCCTCGTAGTG
AACTTTGATAGCTGAACAG -> ACTTTGATAGCTGAACAGA
TCTTAATATCTTGGCCACA -> CTTAATATCTTGGCCACAG
CAGAGTTAGGTTATTGTCC -> AGAGTTAGGTTATTGTCCA
GTACTTGGACGTTCATTAT -> TACTTGGACGTTCATTATA
TGCGATTAATGGGGGCCCT -> GCGATTAATGGGGGCCCTG
CTGGGCTTATGCCTTTACG -> TGGGCTTATGCCTTTACGT
CCGATTTCAAGATGACTGT -> CGATTTCAAGATGACTGTC
ACCCAAATCCACTTGCTTT -> CCCAAATCCACTTGCTTTA
GAGGGGTTTAATTGTTAGT -> AGGGGTTTAATTGTTAGTT
CTTGTATTTTGTTCCTAAC -> TTGTATTTTGTTCCTAACC
ATTTTGTTCCTAACCGTTT -> TTTTGTTCCTAACCGTTTG
TATGCTGAGTCGTCAGCCG -> ATGCTGAGTCGTCAGCCGC
CTTGCGATACGCGGAGGGG -> TTGCGATACGCGGAGGGGT
CGCGTTCCAATGCGCCCTA -> GCGTTCCAATGCGCCCTAC
CCGGATGTGAAAATGTACC -> CGGATGTGAAAATGTACCT
CACCTTCCTATGCATGGAA -> ACCTTCCTATGCATGGAAG
CAACCGATTTCAAGATGAC -> AACCGATTTCAAGATGACT
GCCTCAATGTGTAGTTTTG -> CCTCAATGTGTAGTTTTGC
CCGGTTATCTACCTCAGTG -> CGGTTATCTACCTCAGTGA
CCCTACCCCCGTGCTGCGC -> CCTACCCCCGTGCTGCGCC
TCTAAGTCAGCACGAATCT -> CTAAGTCAGCACGAATCTA
CGGGGTATAAGCGAAGTAC -> GGGGTATAAGCGAAGTACT
CTCCAGCATAGACTGTGTT -> TCCAGCATAGACTGTGTTC
CCGTGCTGCGCCCTGGATA -> CGTGCTGCGCCCTGGATAT
CAGGACGAGTCTAGGCTTC -> AGGACGAGTCTAGGCTTCC
GGCCTCCCACTCTTCGCTG -> GCCTCCCACTCTTCGCTGA
GGGGTTTAATTGTTAGTTC -> GGGTTTAATTGTTAGTTCA
GCATACACGGGCATGGATT -> CATACACGGGCATGGATTG
CAATTGACATTAGACGACT -> AATTGACATTAGACGACTC
AGTCAGACCTTCTGAATTA -> GTCAGACCTTCTGAATTAA
GTCTCGCATACACGGGCAT -> TCTCGCATACACGGGCATG
TTTGTGACTACTAAAGGTA -> TTGTGACTACTAAAGGTAG
CCCTGGGAGTAATACATGA -> CCTGGGAGTAATACATGAC
AGTACTTGGACGTTCACGG -> GTACTTGGACGTTCACGGG
ATGTCTTTGCGTATACGAG -> TGTCTTTGCGTATACGAGA
ATGAGTCAGGAATGACCAC -> TGAGTCAGGAATGACCACT
TGGACGTTCAGGCCTATGA -> GGACGTTCAGGCCTATGAT
TATCGACCTTCCTATGCAT -> ATCGACCTTCCTATGCATG
CTATGCATGGAAGCCATCT -> TATGCATGGAAGCCATCTT
ATACGCTAGGTTTTGTGGC -> TACGCTAGGTTTTGTGGCA
AAGCCAGAAGTACTTGGAC -> AGCCAGAAGTACTTGGACG
GTAGCCACCTTAACGCGTT -> TAGCCACCTTAACGCGTTC
TCTTACAATAGAACCGAAT -> CTTACAATAGAACCGAATT
ACGTTCATTATAATATCGA -> CGTTCATTATAATATCGAC
GTACAATTGCCTAGGGTAC -> TACAATTGCCTAGGGTACC
ACTAAAGGTAGCGCGCCGC -> CTAAAGGTAGCGCGCCGCA
CGGGTCCCCGCACCTTCCT -> GGGTCCCCGCACCTTCCTA
TAGGTTTGTGACTACTAAA -> AGGTTTGTGACTACTAAAG
TTATGTCACATGGCCGTTT -> TATGTCACATGGCCGTTTT
TGGACGTTCATTATAATAT -> GGACGTTCATTATAATATC
GTACATGTTGGGTACCAGA -> TACATGTTGGGTACCAGAG
ACACACCCCATCCTCAGAG -> CACACCCCATCCTCAGAGT
GTGTATTCGGCAGAATAAG -> TGTATTCGGCAGAATAAGA
GTGCTGCGCCCTGGATATC -> TGCTGCGCCCTGGATATCC
TTAGTTCATCGCCAGAGAA -> TAGTTCATCGCCAGAGAAG
ATCGAGACGGTCAGGCGGT -> TCGAGACGGTCAGGCGGTT
AGCTGAGCCGTGTTAGCTC -> GCTGAGCCGTGTTAGCTCA
AGCCCGATGCTGGACGAAA -> GCCCGATGCTGGACGAAAG
CGGTCAGGCGGTTCAAAAA -> GGTCAGGCGGTTCAAAAAC
ACTTGGACGTTCACGGGTC -> CTTGGACGTTCACGGGTCC
AGCTAAGCTTGACTTGTTC -> GCTAAGCTTGACTTGTTCG
AAGCAATCTCGAACCTTCC -> AGCAATCTCGAACCTTCCT
GTATGCTGAGTCGTCAGCC -> TATGCTGAGTCGTCAGCCG
CGTCCCCGCATAGTTAGTC -> GTCCCCGCATAGTTAGTCG
TCTTGGCACGTATCTAACC -> CTTGGCACGTATCTAACCG
ACCCCATCCTCAGAGTTAG -> CCCCATCCTCAGAGTTAGG
GTTAGGTTATTGTCCATGG -> TTAGGTTATTGTCCATGGC
GCTGACTATCTCGGGGTAT -> CTGACTATCTCGGGGTATA
GGTTTGTGACTACTAAAGG -> GTTTGTGACTACTAAAGGT
GCGGAAGTACTTGGACGTT -> CGGAAGTACTTGGACGTTC
TCAAGCAATCTCGAACCTT -> CAAGCAATCTCGAACCTTC
AGCAAGACACTGCAAGTTA -> GCAAGACACTGCAAGTTAG
GCAAGACACTGCAAGTTAG -> CAAGACACTGCAAGTTAGG
CCACTGAAGACAATACTCG -> CACTGAAGACAATACTCGG
TGCATGGAAGTCATTTTCG -> GCATGGAAGTCATTTTCGT
GCCAGAGAAGATATTTGAT -> CCAGAGAAGATATTTGATT
GGCGGGAACTCAAGTGAGT -> GCGGGAACTCAAGTGAGTC
ACTGAAGACAATACTCGGG -> CTGAAGACAATACTCGGGT
AATACGCTAGGTTTTGTGG -> ATACGCTAGGTTTTGTGGC
CATCGCCAGAGAAGATATT -> ATCGCCAGAGAAGATATTT
CGAGACTGAACCGGGGATA -> GAGACTGAACCGGGGATAG
CCATCGTCCCCGCATAGTT -> CATCGTCCCCGCATAGTTA
GCGGGAACTCAAGTGAGTC -> CGGGAACTCAAGTGAGTCA
CACCTATTCCGCAGGACGA -> ACCTATTCCGCAGGACGAG
ACATAAACACGTGACGCCG -> CATAAACACGTGACGCCGT
CGCATGCCGCGGCTTGACA -> GCATGCCGCGGCTTGACAT
GGTTTAATTGTTAGTTCAT -> GTTTAATTGTTAGTTCATC
ATTGACATTAGACGACTCG -> TTGACATTAGACGACTCGC
GCCAGCAAGACACTGCAAG -> CCAGCAAGACACTGCAAGT
ACACGTGTCGTAAAACTCC -> CACGTGTCGTAAAACTCCT
CCACCGTCCGATCACATTC -> CACCGTCCGATCACATTCC
GAAACACACCCCATCCTCA -> AAACACACCCCATCCTCAG
AGGAGTAGTGATCGGTGGC -> GGAGTAGTGATCGGTGGCA
ACACCACTGGATATCTAAA -> CACCACTGGATATCTAAAA
CTAGAACCACACTTACGCG -> TAGAACCACACTTACGCGA
AGTTTTGCGTACAGCTGGG -> GTTTTGCGTACAGCTGGGC
CTTGACTTGTTCGTTAATT -> TTGACTTGTTCGTTAATTC
TCAGAGTTAGGTTATTGTC -> CAGAGTTAGGTTATTGTCC
GGGTACCGACGGTTATCTA -> GGTACCGACGGTTATCTAT
CCTACGCAGTGTTCCAGTT -> CTACGCAGTGTTCCAGTTT
ACCGATAATCCCGAGACTG -> CCGATAATCCCGAGACTGA
ATGATACTAAGGGTGCATA -> TGATACTAAGGGTGCATAT
ATACCACACTAGAACCACA -> TACCACACTAGAACCACAC
ACGATGCGGCCGCATACGA -> CGATGCGGCCGCATACGAA
GACATTAGACGACTCGCCA -> ACATTAGACGACTCGCCAG
ATTAATGCGTAGAAGTCTT -> TTAATGCGTAGAAGTCTTC
TGTTTACTCCAGCATAGAC -> GTTTACTCCAGCATAGACT
CAATTGCCTAGGGTACCGA -> AATTGCCTAGGGTACCGAC
TGTTCCAGTTTCGTCGGGG -> GTTCCAGTTTCGTCGGGGC
ACCTCAGTGATTAATAGTG -> CCTCAGTGATTAATAGTGC
GGTTTCACACCTATTCCGC -> GTTTCACACCTATTCCGCA
TGGCCGTTTTAACCGCAAG -> GGCCGTTTTAACCGCAAGC
AGGCTTCCTCGTAGTGGAT -> GGCTTCCTCGTAGTGGATA
TTTGATAGCTGAACAGAGC -> TTGATAGCTGAACAGAGCT
TGTACCTACATGACCTTGA -> GTACCTACATGACCTTGAA
GCGAAGTACTTGGACGTTC -> CGAAGTACTTGGACGTTCA
TGGCGGTCAATTAATGCGT -> GGCGGTCAATTAATGCGTA
CTGAAGACAATACTCGGGT -> TGAAGACAATACTCGGGTA
ACTCGGGTACTGGCCCTGG -> CTCGGGTACTGGCCCTGGG
GACCACTATTTTACCGGTT -> ACCACTATTTTACCGGTTA
AATCTTGGCACGTATCTAA -> ATCTTGGCACGTATCTAAC
TAAACACGTGACGCCGTAC -> AAACACGTGACGCCGTACC
CGCTGACTATCTCGGGGTA -> GCTGACTATCTCGGGGTAT
GTTGGGTACCAGAGGGGAG -> TTGGGTACCAGAGGGGAGT
GAGACGGTCAGGCGGTTCA -> AGACGGTCAGGCGGTTCAA
ATATAGACGCATAGCAATC -> TATAGACGCATAGCAATCT
TTGCGACCCACTGAAGACA -> TGCGACCCACTGAAGACAA
TTGATTGAATTTTGCATGT -> TGATTGAATTTTGCATGTT
TCTACTACGGATCCCATAC -> CTACTACGGATCCCATACG
AGGGGAGTCCGGCGGGAAC -> GGGGAGTCCGGCGGGAACT
GATATTAAGCGCACCACGC -> ATATTAAGCGCACCACGCC
CGATTTCAAGATGACTGTC -> GATTTCAAGATGACTGTCC
TCTGTGCTTAGAAACACAC -> CTGTGCTTAGAAACACACC
GCCGCGCTGTTTACTCCAG -> CCGCGCTGTTTACTCCAGC
TTGGACGTTCATTATAATA -> TGGACGTTCATTATAATAT
AGTTAGTCGGTGGTAGAAA -> GTTAGTCGGTGGTAGAAAT
TGCATATGTCTTTGCGTAT -> GCATATGTCTTTGCGTATA
TATTCGGCAGAATAAGAGA -> ATTCGGCAGAATAAGAGAA
GTAGTGGATATTAAGCGCA -> TAGTGGATATTAAGCGCAC
TAATATCGACCTTCCTATG -> AATATCGACCTTCCTATGC
ATTGCGCGCATGCCGCGGC -> TTGCGCGCATGCCGCGGCT
GGTAGAAATACCACACTAG -> GTAGAAATACCACACTAGA
GGGCTTATGCCTTTACGTG -> GGCTTATGCCTTTACGTGT
TTCCTCAGACACCAGTGGC -> TCCTCAGACACCAGTGGCG
ATGATCTACTACGGATCCC -> TGATCTACTACGGATCCCA
TTATTGTCCATGGCGCTTG -> TATTGTCCATGGCGCTTGC
TAGGCTTCCTCGTAGTGGA -> AGGCTTCCTCGTAGTGGAT
ATAAGCGAAGTACTTGGAC -> TAAGCGAAGTACTTGGACG
ATAGTGCCAGAGGTCTTCA -> TAGTGCCAGAGGTCTTCAA
CCAGCAAGACACTGCAAGT -> CAGCAAGACACTGCAAGTT
CCATCAGGGTGGCGTGGGA -> CATCAGGGTGGCGTGGGAG
CAGAGCTGGTCGCCCAGAG -> AGAGCTGGTCGCCCAGAGC
AGGTAGCTTATGATCTACT -> GGTAGCTTATGATCTACTA
TTAACCGCAAGCCAGAAGT -> TAACCGCAAGCCAGAAGTA
AAGTCTTCCACGCGTATGC -> AGTCTTCCACGCGTATGCC
CAGCTAAGCTTGACTTGTT -> AGCTAAGCTTGACTTGTTC
ATGATGACCTTCCTATGCA -> TGATGACCTTCCTATGCAT
ACTCTTCGCTGACTATCTC -> CTCTTCGCTGACTATCTCG
AGGTTTGTGACTACTAAAG -> GGTTTGTGACTACTAAAGG
TTGCCCTAGTCCCCCCCAT -> TGCCCTAGTCCCCCCCATC
ATTACACCAAGCATGTCGC -> TTACACCAAGCATGTCGCA
TCTATTACACCAAGCATGT -> CTATTACACCAAGCATGTC
TATGCATGGAAGCCATCTT -> ATGCATGGAAGCCATCTTA
CATCGTCCCCGCATAGTTA -> ATCGTCCCCGCATAGTTAG
TTTAATTGTTAGTTCATCG -> TTAATTGTTAGTTCATCGC
CCAGAGGGGAGTCCGGCGG -> CAGAGGGGAGTCCGGCGGG
CTATCTCGGGGTATAAGCG -> TATCTCGGGGTATAAGCGA
ATCCTACCCTCCGGTGCCA -> TCCTACCCTCCGGTGCCAA
CTGAGCCGTGTTAGCTCAC -> TGAGCCGTGTTAGCTCACG
GCACGAATCTATTAGAGCC -> CACGAATCTATTAGAGCCT
GATACGCGGAGGGGTTTAA -> ATACGCGGAGGGGTTTAAT
AGTAGTGATCGGTGGCACT -> GTAGTGATCGGTGGCACTA
TCTAAAAACCCAAATCCAC -> CTAAAAACCCAAATCCACT
GAACCGAATTCTGGGCAGA -> AACCGAATTCTGGGCAGAG
GGACGTTCAGGCCTATGAT -> GACGTTCAGGCCTATGATG
CGTCCTCCTTTGAGGGATA -> GTCCTCCTTTGAGGGATAC
GCGTATACGAGAGCGAGAC -> CGTATACGAGAGCGAGACA
TTTACCGGTTATCTACCTC -> TTACCGGTTATCTACCTCA
GGTGACCGTGCGATTAATG -> GTGACCGTGCGATTAATGG
GAGTCCGGCGGGAACTCAA -> AGTCCGGCGGGAACTCAAG
GTAATACATGACCGGATGT -> TAATACATGACCGGATGTG
CCTAGGTTTGTGACTACTA -> CTAGGTTTGTGACTACTAA
AACCGATTTCAAGATGACT -> ACCGATTTCAAGATGACTG
CCATACGGCCAAACCGATA -> CATACGGCCAAACCGATAA
CGCAGTGTTCCAGTTTCGT -> GCAGTGTTCCAGTTTCGTC
TTCTGAATTAAGGATAACA -> TCTGAATTAAGGATAACAG
CTTGAAGTGACTAATGAGT -> TTGAAGTGACTAATGAGTC
GTCCTTCTGAAGACAGGAC -> TCCTTCTGAAGACAGGACA
GTTATCTACCTCAGTGATT -> TTATCTACCTCAGTGATTA
AGAAATACCACACTAGAAC -> GAAATACCACACTAGAACC
CACGTGTCGTAAAACTCCT -> ACGTGTCGTAAAACTCCTC
GACCCACTGAAGACAATAC -> ACCCACTGAAGACAATACT
TGTTGTACAATTGCCTAGG -> GTTGTACAATTGCCTAGGG
TAGAAGTCTTCCACGCGTA -> AGAAGTCTTCCACGCGTAT
CGGGCATGGATTGCGATCT -> GGGCATGGATTGCGATCTA
AAGTACTTGGACGTTCACG -> AGTACTTGGACGTTCACGG
TTACGTGTGCGGAAGTACT -> TACGTGTGCGGAAGTACTT
CAATTAATGCGTAGAAGTC -> AATTAATGCGTAGAAGTCT
GTTCAAAAACAATGGGCAG -> TTCAAAAACAATGGGCAGT
ACTTTGATAGCTGAACAGA -> CTTTGATAGCTGAACAGAG
AGAGCTGGTCGCCCAGAGC -> GAGCTGGTCGCCCAGAGCC
ATCTATTACACCAAGCATG -> TCTATTACACCAAGCATGT
GAGCGAGACATAGCGGAGG -> AGCGAGACATAGCGGAGGG
AAGTACTTGGACGTTCAAG -> AGTACTTGGACGTTCAAGC
CCAAACCGATAATCCCGAG -> CAAACCGATAATCCCGAGA
ATATTTGATTGAATTTTGC -> TATTTGATTGAATTTTGCA
GAAGTACTTGGACGTTCAG -> AAGTACTTGGACGTTCAGG
GGTTATGTCACATGGCCGT -> GTTATGTCACATGGCCGTT
TAGAAACACACCCCATCCT -> AGAAACACACCCCATCCTC
AATCCACTTGCTTTACCGT -> ATCCACTTGCTTTACCGTG
TACACCAAGCATGTCGCAA -> ACACCAAGCATGTCGCAAT
CGCCAATTGACATTAGACG -> GCCAATTGACATTAGACGA
ATATGTCTTTGCGTATACG -> TATGTCTTTGCGTATACGA
CTATTAGAGCCTGTTGTAC -> TATTAGAGCCTGTTGTACA
TAGCGGAGGGTTTCACACC -> AGCGGAGGGTTTCACACCT
TCCAGCATAGACTGTGTTC -> CCAGCATAGACTGTGTTCG
GATCGGTGGCACTATGGCT -> ATCGGTGGCACTATGGCTA
CGTTAATTCCAAGCTAGAC -> GTTAATTCCAAGCTAGACC
TTGCCTAGGTTTGTGACTA -> TGCCTAGGTTTGTGACTAC
CAGCGGAGGTTGCGACCCA -> AGCGGAGGTTGCGACCCAC
CTCGTCCTCCTTTGAGGGA -> TCGTCCTCCTTTGAGGGAT
ATAGACGCATAGCAATCTT -> TAGACGCATAGCAATCTTA
TGTTCCCCTCGGGGAGCAG -> GTTCCCCTCGGGGAGCAGG
CTGAACCGGGGATAGCCAT -> TGAACCGGGGATAGCCATC
CTTAACGCGTTCCAATGCG -> TTAACGCGTTCCAATGCGC
GGTGGCACTATGGCTAAGA -> GTGGCACTATGGCTAAGAA
TCTTCGCTGACTATCTCGG -> CTTCGCTGACTATCTCGGG
GTAGCGCGCCGCAGCTAAG -> TAGCGCGCCGCAGCTAAGC
TATATTGCGACCTTAATAC -> ATATTGCGACCTTAATACG
TAGAACCACACTTACGCGA -> AGAACCACACTTACGCGAC
ACTCGTCCTCCTTTGAGGG -> CTCGTCCTCCTTTGAGGGA
GAGCCGTGTTAGCTCACGG -> AGCCGTGTTAGCTCACGGC
TACTCCAGCATAGACTGTG -> ACTCCAGCATAGACTGTGT
ACTCAAGTGAGTCAGACCT -> CTCAAGTGAGTCAGACCTT
GAATTGCGCGCATGCCGCG -> AATTGCGCGCATGCCGCGG
CACACTTACGCGACCGCAA -> ACACTTACGCGACCGCAAC
CGCGCATGCCGCGGCTTGA -> GCGCATGCCGCGGCTTGAC
ACAGCTGGGCTTATGCCTT -> CAGCTGGGCTTATGCCTTT
TGCATGGAAGGAGTAGTGA -> GCATGGAAGGAGTAGTGAT
CTCAATGTGTAGTTTTGCG -> TCAATGTGTAGTTTTGCGT
TGATACTAAGGGTGCATAT -> GATACTAAGGGTGCATATG
TAGTGAATTGCGCGCATGC -> AGTGAATTGCGCGCATGCC
GCGCTTGCCCTAGTCCCCC -> CGCTTGCCCTAGTCCCCCC
GCGGAGGGGTTTAATTGTT -> CGGAGGGGTTTAATTGTTA
CTGAACAGAGCTGAGCCGT -> TGAACAGAGCTGAGCCGTG
GCCCTGGGAGTAATACATG -> CCCTGGGAGTAATACATGA
CCTAGTCCCCCCCATCAGG -> CTAGTCCCCCCCATCAGGG
GGATACGACGAGTCCTTCT -> GATACGACGAGTCCTTCTG
CCCATCAGGGTGGCGTGGG -> CCATCAGGGTGGCGTGGGA
AAGACACTGCAAGTTAGGT -> AGACACTGCAAGTTAGGTA
AGCCTCAATGTGTAGTTTT -> GCCTCAATGTGTAGTTTTG
CTACCCTCCGGTGCCAATG -> TACCCTCCGGTGCCAATGT
AACCGATAATCCCGAGACT -> ACCGATAATCCCGAGACTG
AGCTTATGATCTACTACGG -> GCTTATGATCTACTACGGA
TGCCTTTACGTGTGCGGAA -> GCCTTTACGTGTGCGGAAG
TACCGACGGTTATCTATTA -> ACCGACGGTTATCTATTAC
GCATCCTACCCTCCGGTGC -> CATCCTACCCTCCGGTGCC
CGTGGGAGAATCGGGTAAC -> GTGGGAGAATCGGGTAACG
GTCCGTACATGTTGGGTAC -> TCCGTACATGTTGGGTACC
CCGTACCACCGTCCGATCA -> CGTACCACCGTCCGATCAC
AGACGCATAGCAATCTTAC -> GACGCATAGCAATCTTACA
TGCGCGCATGCCGCGGCTT -> GCGCGCATGCCGCGGCTTG
TCGAACCTTCCTATGCATG -> CGAACCTTCCTATGCATGG
CCGACTCGTCCTCCTTTGA -> CGACTCGTCCTCCTTTGAG
ATATTAAGCGCACCACGCC -> TATTAAGCGCACCACGCCA
GGCCACAGTCCACCAGGCT -> GCCACAGTCCACCAGGCTG
TAAGAAGACTAGGAACACC -> AAGAAGACTAGGAACACCA
CTAAAGGTAGCGCGCCGCA -> TAAAGGTAGCGCGCCGCAG
TTGCGACCTTAATACGCTA -> TGCGACCTTAATACGCTAG
GTGGCGTGGGAGAATCGGG -> TGGCGTGGGAGAATCGGGT
TCATTATAATATCGACCTT -> CATTATAATATCGACCTTC
GTCCCCGCATAGTTAGTCG -> TCCCCGCATAGTTAGTCGG
GGTGCATATGTCTTTGCGT -> GTGCATATGTCTTTGCGTA
TAAGTCAGCACGAATCTAT -> AAGTCAGCACGAATCTATT
TCAGACCTTCTGAATTAAG -> CAGACCTTCTGAATTAAGG
CATGGATTGCGATCTAAGA -> ATGGATTGCGATCTAAGAA
AGACTGTGTTCGCACCTAC -> GACTGTGTTCGCACCTACG
GAATTAAGGATAACAGGCA -> AATTAAGGATAACAGGCAT
AGTCTAGGCTTCCTCGTAG -> GTCTAGGCTTCCTCGTAGT
TACGCAGTGTTCCAGTTTC -> ACGCAGTGTTCCAGTTTCG
CGAGTCTAGGCTTCCTCGT -> GAGTCTAGGCTTCCTCGTA
GGACGAAAGTCTCGCATAC -> GACGAAAGTCTCGCATACA
CTTGTTCGTTAATTCCAAG -> TTGTTCGTTAATTCCAAGC
CTAGTCCCCCCCATCAGGG -> TAGTCCCCCCCATCAGGGT
ACCTTAACGCGTTCCAATG -> CCTTAACGCGTTCCAATGC
TTAGAGCCTGTTGTACAAT -> TAGAGCCTGTTGTACAATT
GAACTTTGATAGCTGAACA -> AACTTTGATAGCTGAACAG
AAAACAATGGGCAGTGCTA -> AAACAATGGGCAGTGCTAG
TGAATTGCGCGCATGCCGC -> GAATTGCGCGCATGCCGCG
CACTATTTTACCGGTTATC -> ACTATTTTACCGGTTATCT
ATTCTGGGCAGAGCTGGTC -> TTCTGGGCAGAGCTGGTCG
TACGCGACCGCAACCGATT -> ACGCGACCGCAACCGATTT
TAGTCGGTGGTAGAAATAC -> AGTCGGTGGTAGAAATACC
GCTGTATATTGCGACCTTA -> CTGTATATTGCGACCTTAA
CTCGCCAGCAAGACACTGC -> TCGCCAGCAAGACACTGCA
GTTTCGTCGGGGCGCAGTG -> TTTCGTCGGGGCGCAGTGT
CCCGTGCTGCGCCCTGGAT -> CCGTGCTGCGCCCTGGATA
GGGAGTCCGGCGGGAACTC -> GGAGTCCGGCGGGAACTCA
GATGACTGTCCCACACAGT -> ATGACTGTCCCACACAGTA
CCACTATTTTACCGGTTAT -> CACTATTTTACCGGTTATC
CTCCGGTGCCAATGTTCTA -> TCCGGTGCCAATGTTCTAA
ATATCTAAAAACCCAAATC -> TATCTAAAAACCCAAATCC
GTACTGGCCCTGGGAGTAA -> TACTGGCCCTGGGAGTAAT
ATGCGGCCGCATACGAACT -> TGCGGCCGCATACGAACTT
GGTTTTGTGGCATCTTGCG -> GTTTTGTGGCATCTTGCGA
ATCTTGGCCACAGTCCACC -> TCTTGGCCACAGTCCACCA
GTAGTTTTGCGTACAGCTG -> TAGTTTTGCGTACAGCTGG
CCTATTCCGCAGGACGAGT -> CTATTCCGCAGGACGAGTC
AGACATAGCGGAGGGTTTC -> GACATAGCGGAGGGTTTCA
GGCTGGGGTCTGTGCTTAG -> GCTGGGGTCTGTGCTTAGA
ACTTGGACGTTCATTATAA -> CTTGGACGTTCATTATAAT
GCTGAGTCGTCAGCCGCGC -> CTGAGTCGTCAGCCGCGCT
TCTCGAACCTTCCTATGCA -> CTCGAACCTTCCTATGCAT
TATCTAACCGGACAACTAT -> ATCTAACCGGACAACTATG
TGATTAATAGTGCCAGAGG -> GATTAATAGTGCCAGAGGT
CTCGGGGAGCAGGAATCGA -> TCGGGGAGCAGGAATCGAG
AAGTCAGCACGAATCTATT -> AGTCAGCACGAATCTATTA
TCAGCGGAGGTTGCGACCC -> CAGCGGAGGTTGCGACCCA
CTTAATACGCTAGGTTTTG -> TTAATACGCTAGGTTTTGT
GGCTAAGAAGACTAGGAAC -> GCTAAGAAGACTAGGAACA
TGCCGCGGCTTGACATAAA -> GCCGCGGCTTGACATAAAC
CATCAAAGCTGGGGCCTCC -> ATCAAAGCTGGGGCCTCCC
ATGCCGCGGCTTGACATAA -> TGCCGCGGCTTGACATAAA
TATTAGTAGCCACCTTAAC -> ATTAGTAGCCACCTTAACG
GGTAGCGCGCCGCAGCTAA -> GTAGCGCGCCGCAGCTAAG
ACACTAGAACCACACTTAC -> CACTAGAACCACACTTACG
GAAGACAATACTCGGGTAC -> AAGACAATACTCGGGTACT
GGGGTATAAGCGAAGTACT -> GGGTATAAGCGAAGTACTT
CCTCAGTGATTAATAGTGC -> CTCAGTGATTAATAGTGCC
TTGAAGTGACTAATGAGTC -> TGAAGTGACTAATGAGTCA
CAGGAATCGAGACGGTCAG -> AGGAATCGAGACGGTCAGG
ACCGTCCGATCACATTCCT -> CCGTCCGATCACATTCCTC
TTTGATTGAATTTTGCATG -> TTGATTGAATTTTGCATGT
GTGTTCGCACCTACGCAGT -> TGTTCGCACCTACGCAGTG
TCAAGTGAGTCAGACCTTC -> CAAGTGAGTCAGACCTTCT
CAAGCTAGACCGCTTGTTA -> AAGCTAGACCGCTTGTTAT
ATATTGCGACCTTAATACG -> TATTGCGACCTTAATACGC
CTGCGCCCTGGATATCCTG -> TGCGCCCTGGATATCCTGG
GGCAAATGCCGCTGGCGGT -> GCAAATGCCGCTGGCGGTC
ATAGAACCGAATTCTGGGC -> TAGAACCGAATTCTGGGCA
CGGATGTGAAAATGTACCT -> GGATGTGAAAATGTACCTA
ATAGACTGTGTTCGCACCT -> TAGACTGTGTTCGCACCTA
ATAACAGGCATCAAAGCTG -> TAACAGGCATCAAAGCTGG
TGTGACTACTAAAGGTAGC -> GTGACTACTAAAGGTAGCG
ACTATTTTACCGGTTATCT -> CTATTTTACCGGTTATCTA
TTTGCATGTTCCCCTCGGG -> TTGCATGTTCCCCTCGGGG
GCAAGCCAGAAGTACTTGG -> CAAGCCAGAAGTACTTGGA
CTGTTGTACAATTGCCTAG -> TGTTGTACAATTGCCTAGG
GGTACCAGAGGGGAGTCCG -> GTACCAGAGGGGAGTCCGG
GCGTATGCCCTCGTCCGAC -> CGTATGCCCTCGTCCGACT
GGAGTAATACATGACCGGA -> GAGTAATACATGACCGGAT
AGTCCTTCTGAAGACAGGA -> GTCCTTCTGAAGACAGGAC
CCACACTAGAACCACACTT -> CACACTAGAACCACACTTA
GGCACGTATCTAACCGGAC -> GCACGTATCTAACCGGACA
GGTGGTAGAAATACCACAC -> GTGGTAGAAATACCACACT
GACGTTCAAGCAATCTCGA -> ACGTTCAAGCAATCTCGAA
AGCGAAGTACTTGGACGTT -> GCGAAGTACTTGGACGTTC
GCAAGTTAGGTAGCTTATG -> CAAGTTAGGTAGCTTATGA
TATCCTGGTTATGTCACAT -> ATCCTGGTTATGTCACATG
TACCCTCCGGTGCCAATGT -> ACCCTCCGGTGCCAATGTT
CCCTCGGGGAGCAGGAATC -> CCTCGGGGAGCAGGAATCG
GCTAAGAAGACTAGGAACA -> CTAAGAAGACTAGGAACAC
ATGGAAGGAGTAGTGATCG -> TGGAAGGAGTAGTGATCGG
GAGTAGTGATCGGTGGCAC -> AGTAGTGATCGGTGGCACT
AAGTGAGTCAGACCTTCTG -> AGTGAGTCAGACCTTCTGA
CGGCCAAACCGATAATCCC -> GGCCAAACCGATAATCCCG
CCACCAGGCTGTATATTGC -> CACCAGGCTGTATATTGCG
GCATGGAAGCATTCACACA -> CATGGAAGCATTCACACAT
TACGAGAGCGAGACATAGC -> ACGAGAGCGAGACATAGCG
CGACCTTAATACGCTAGGT -> GACCTTAATACGCTAGGTT
ATGGATTGCGATCTAAGAA -> TGGATTGCGATCTAAGAAC
TTGAATTTTGCATGTTCCC -> TGAATTTTGCATGTTCCCC
GGCAGAGCTGGTCGCCCAG -> GCAGAGCTGGTCGCCCAGA
CACCAAGCATGTCGCAATC -> ACCAAGCATGTCGCAATCT
ACCTTGAAGTGACTAATGA -> CCTTGAAGTGACTAATGAG
CACTTACGCGACCGCAACC -> ACTTACGCGACCGCAACCG
GCGGAGGGTTTCACACCTA -> CGGAGGGTTTCACACCTAT
GTCCCCGCACCTTCCTATG -> TCCCCGCACCTTCCTATGC
GCAGTGTTCCAGTTTCGTC -> CAGTGTTCCAGTTTCGTCG
TCGGTGGCACTATGGCTAA -> CGGTGGCACTATGGCTAAG
CTCCTTTGAGGGATACGAC -> TCCTTTGAGGGATACGACG
TCTACCTCAGTGATTAATA -> CTACCTCAGTGATTAATAG
CACTCTTCGCTGACTATCT -> ACTCTTCGCTGACTATCTC
CCGCGGCTTGACATAAACA -> CGCGGCTTGACATAAACAC
CTAGACCGCTTGTTATCAG -> TAGACCGCTTGTTATCAGC
TTATCAGCGGAGGTTGCGA -> TATCAGCGGAGGTTGCGAC
GCTAGACCGCTTGTTATCA -> CTAGACCGCTTGTTATCAG
CTACGGATCCCATACGGCC -> TACGGATCCCATACGGCCA
AACCGAATTCTGGGCAGAG -> ACCGAATTCTGGGCAGAGC
TAGACCGCTTGTTATCAGC -> AGACCGCTTGTTATCAGCG
TTTAACCGCAAGCCAGAAG -> TTAACCGCAAGCCAGAAGT
TATGTCACATGGCCGTTTT -> ATGTCACATGGCCGTTTTA
CCGGTGCCAATGTTCTAAG -> CGGTGCCAATGTTCTAAGT
CACTGGATATCTAAAAACC -> ACTGGATATCTAAAAACCC
GCGATCTAAGAACACGTGT -> CGATCTAAGAACACGTGTC
AGAAGTACTTGGACGTTCA -> GAAGTACTTGGACGTTCAA
TCAATGTGTAGTTTTGCGT -> CAATGTGTAGTTTTGCGTA
CCCTCCGGTGCCAATGTTC -> CCTCCGGTGCCAATGTTCT
CGATACGCGGAGGGGTTTA -> GATACGCGGAGGGGTTTAA
TGATCGGTGGCACTATGGC -> GATCGGTGGCACTATGGCT
CCGCAGCTAAGCTTGACTT -> CGCAGCTAAGCTTGACTTG
CGGAGGGGTTTAATTGTTA -> GGAGGGGTTTAATTGTTAG
GGCGGTTCAAAAACAATGG -> GCGGTTCAAAAACAATGGG
CTCAGACACCAGTGGCGGT -> TCAGACACCAGTGGCGGTG
CATGACCGGATGTGAAAAT -> ATGACCGGATGTGAAAATG
TGGCGTGGGAGAATCGGGT -> GGCGTGGGAGAATCGGGTA
GATACGACGAGTCCTTCTG -> ATACGACGAGTCCTTCTGA
ACAATAGAACCGAATTCTG -> CAATAGAACCGAATTCTGG
TTAATTGTTAGTTCATCGC -> TAATTGTTAGTTCATCGCC
TACTTGGACGTTCAAGCAA -> ACTTGGACGTTCAAGCAAT
AGTTCATCGCCAGAGAAGA -> GTTCATCGCCAGAGAAGAT
TTAAGCGCACCACGCCAAT -> TAAGCGCACCACGCCAATT
ATAATATCGACCTTCCTAT -> TAATATCGACCTTCCTATG
CGTACAGCTGGGCTTATGC -> GTACAGCTGGGCTTATGCC
GCCACCTTAACGCGTTCCA -> CCACCTTAACGCGTTCCAA
TTTTGCGTACAGCTGGGCT -> TTTGCGTACAGCTGGGCTT
AATTGTTAGTTCATCGCCA -> ATTGTTAGTTCATCGCCAG
GGGGGCCCTGTGGGCTGGG -> GGGGCCCTGTGGGCTGGGG
GTGTTAGCTCACGGCAAAT -> TGTTAGCTCACGGCAAATG
CATTCACACATTGCCTAGG -> ATTCACACATTGCCTAGGT
CACGCGTATGCCCTCGTCC -> ACGCGTATGCCCTCGTCCG
TACTTGGACGTTCATTATA -> ACTTGGACGTTCATTATAA
TGTGGCATCTTGCGATACG -> GTGGCATCTTGCGATACGC
GCTGAGCCGTGTTAGCTCA -> CTGAGCCGTGTTAGCTCAC
GGGTGGCGTGGGAGAATCG -> GGTGGCGTGGGAGAATCGG
GCCATCTTAATATCTTGGC -> CCATCTTAATATCTTGGCC
GCTGGTCGCCCAGAGCCAA -> CTGGTCGCCCAGAGCCAAG
TTAGAAACACACCCCATCC -> TAGAAACACACCCCATCCT
CAGAGCCAAGCCTCAATGT -> AGAGCCAAGCCTCAATGTG
CAAGACACTGCAAGTTAGG -> AAGACACTGCAAGTTAGGT
ACGCGACCGCAACCGATTT -> CGCGACCGCAACCGATTTC
CGTTCATTATAATATCGAC -> GTTCATTATAATATCGACC
GCTCACGGCAAATGCCGCT -> CTCACGGCAAATGCCGCTG
CTTTACGTGTGCGGAAGTA -> TTTACGTGTGCGGAAGTAC
TCGCACCTACGCAGTGTTC -> CGCACCTACGCAGTGTTCC
CACTGAAGACAATACTCGG -> ACTGAAGACAATACTCGGG
GAGAACTTGGTGACCGTGC -> AGAACTTGGTGACCGTGCG
CAGGCCTATGATGACCTTC -> AGGCCTATGATGACCTTCC
ACCGGTTATCTACCTCAGT -> CCGGTTATCTACCTCAGTG
AACCCAAATCCACTTGCTT -> ACCCAAATCCACTTGCTTT
TGTTCGCACCTACGCAGTG -> GTTCGCACCTACGCAGTGT
TATGGCTAAGAAGACTAGG -> ATGGCTAAGAAGACTAGGA
GGAGTAGTGATCGGTGGCA -> GAGTAGTGATCGGTGGCAC
CACACCCCATCCTCAGAGT -> ACACCCCATCCTCAGAGTT
TTCCAAGCTAGACCGCTTG -> TCCAAGCTAGACCGCTTGT
CCGCATACGAACTTTGATA -> CGCATACGAACTTTGATAG
AAAATGTACCTACATGACC -> AAATGTACCTACATGACCT
TTCCTATGCATGGAAGCCA -> TCCTATGCATGGAAGCCAT
TGGGCTGGGGTCTGTGCTT -> GGGCTGGGGTCTGTGCTTA
GCTAAGCTTGACTTGTTCG -> CTAAGCTTGACTTGTTCGT
TACGACGAGTCCTTCTGAA -> ACGACGAGTCCTTCTGAAG
GGGGCCTCCCACTCTTCGC -> GGGCCTCCCACTCTTCGCT
GAAGCCATCTTAATATCTT -> AAGCCATCTTAATATCTTG
TGATGACCTTCCTATGCAT -> GATGACCTTCCTATGCATG
TTAGGTTATTGTCCATGGC -> TAGGTTATTGTCCATGGCG
AGTGGATATTAAGCGCACC -> GTGGATATTAAGCGCACCA
GGCAGAATAAGAGAACTTG -> GCAGAATAAGAGAACTTGG
CGCACCTTCCTATGCATGG -> GCACCTTCCTATGCATGGA
GACACCAGTGGCGGTGTAT -> ACACCAGTGGCGGTGTATT
GACATAAACACGTGACGCC -> ACATAAACACGTGACGCCG
GTTCATCGCCAGAGAAGAT -> TTCATCGCCAGAGAAGATA
TTGGACGTTCAAGCAATCT -> TGGACGTTCAAGCAATCTC
TATGCCTTTACGTGTGCGG -> ATGCCTTTACGTGTGCGGA
CCTTCCTATGCATGGAAGG -> CTTCCTATGCATGGAAGGA
CCACACAGTATGCTGAGTC -> CACACAGTATGCTGAGTCG
TGCCGCTGGCGGTCAATTA -> GCCGCTGGCGGTCAATTAA
ATGCATGGAAGGAGTAGTG -> TGCATGGAAGGAGTAGTGA
GGGCAGTGCTAGAGTTATA -> GGCAGTGCTAGAGTTATAT
AGTTAGGTAGCTTATGATC -> GTTAGGTAGCTTATGATCT
AGTTAGGTTATTGTCCATG -> GTTAGGTTATTGTCCATGG
AGTCCACCAGGCTGTATAT -> GTCCACCAGGCTGTATATT
TGGCACGTATCTAACCGGA -> GGCACGTATCTAACCGGAC
GGGCGCAGTGTATTCGGCA -> GGCGCAGTGTATTCGGCAG
TACATGCATCCTACCCTCC -> ACATGCATCCTACCCTCCG
CGTGTCGTAAAACTCCTCG -> GTGTCGTAAAACTCCTCGA
TAAAGGTAGCGCGCCGCAG -> AAAGGTAGCGCGCCGCAGC
CGCAGTGTATTCGGCAGAA -> GCAGTGTATTCGGCAGAAT
TCCTCAGACACCAGTGGCG -> CCTCAGACACCAGTGGCGG
TGGCGCTTGCCCTAGTCCC -> GGCGCTTGCCCTAGTCCCC
TATATAGACGCATAGCAAT -> ATATAGACGCATAGCAATC
GTGAGTCAGACCTTCTGAA -> TGAGTCAGACCTTCTGAAT
AACTCCTCGATAACGATGC -> ACTCCTCGATAACGATGCG
CGCACCTACGCAGTGTTCC -> GCACCTACGCAGTGTTCCA
AGAATAAGAGAACTTGGTG -> GAATAAGAGAACTTGGTGA
CGTGTGCGGAAGTACTTGG -> GTGTGCGGAAGTACTTGGA
AAAAACAATGGGCAGTGCT -> AAAACAATGGGCAGTGCTA
CGTAGAAGTCTTCCACGCG -> GTAGAAGTCTTCCACGCGT
ACAACTATGATACTAAGGG -> CAACTATGATACTAAGGGT
GGACGTTCACGGGTCCCCG -> GACGTTCACGGGTCCCCGC
CTTGGTGACCGTGCGATTA -> TTGGTGACCGTGCGATTAA
GGTTGCGACCCACTGAAGA -> GTTGCGACCCACTGAAGAC
AGACAGGACACGATTCTTG -> GACAGGACACGATTCTTGT
TGGGCAGAGCTGGTCGCCC -> GGGCAGAGCTGGTCGCCCA
AAACCCAAATCCACTTGCT -> AACCCAAATCCACTTGCTT
AACCGTTTGTCCGTACATG -> ACCGTTTGTCCGTACATGT
CGACTCGTCCTCCTTTGAG -> GACTCGTCCTCCTTTGAGG
TGCCTAGGTTTGTGACTAC -> GCCTAGGTTTGTGACTACT
CCAATGCGCCCTACCCCCG -> CAATGCGCCCTACCCCCGT
GTCGCAATCTTGGCACGTA -> TCGCAATCTTGGCACGTAT
ACACCTATTCCGCAGGACG -> CACCTATTCCGCAGGACGA
GCGGTCAATTAATGCGTAG -> CGGTCAATTAATGCGTAGA
GCGCCCTACCCCCGTGCTG -> CGCCCTACCCCCGTGCTGC
CTGGGGTCTGTGCTTAGAA -> TGGGGTCTGTGCTTAGAAA
GGCGTGGGAGAATCGGGTA -> GCGTGGGAGAATCGGGTAA
TCGCAATCTTGGCACGTAT -> CGCAATCTTGGCACGTATC
TATCTAAAAACCCAAATCC -> ATCTAAAAACCCAAATCCA
GTACCTACATGACCTTGAA -> TACCTACATGACCTTGAAG
TGATCTACTACGGATCCCA -> GATCTACTACGGATCCCAT
GTCGTAAAACTCCTCGATA -> TCGTAAAACTCCTCGATAA
TAACCGGACAACTATGATA -> AACCGGACAACTATGATAC
AGAAGACTAGGAACACCAC -> GAAGACTAGGAACACCACT
TCGTAGTGGATATTAAGCG -> CGTAGTGGATATTAAGCGC
TAGTCCCCCCCATCAGGGT -> AGTCCCCCCCATCAGGGTG
TTAACGCGTTCCAATGCGC -> TAACGCGTTCCAATGCGCC
ACGTTCAAGCAATCTCGAA -> CGTTCAAGCAATCTCGAAC
GGACAACTATGATACTAAG -> GACAACTATGATACTAAGG
ATATCTTGGCCACAGTCCA -> TATCTTGGCCACAGTCCAC
AGTCAGCACGAATCTATTA -> GTCAGCACGAATCTATTAG
TCGTCCGACTCGTCCTCCT -> CGTCCGACTCGTCCTCCTT
TCGTGGTTAGCCCGATGCT -> CGTGGTTAGCCCGATGCTG
ACCGATTTCAAGATGACTG -> CCGATTTCAAGATGACTGT
GACGTTCATTATAATATCG -> ACGTTCATTATAATATCGA
ATGTACCTACATGACCTTG -> TGTACCTACATGACCTTGA
GTCAGACCTTCTGAATTAA -> TCAGACCTTCTGAATTAAG
AAGTACTTGGACGTTCAGG -> AGTACTTGGACGTTCAGGC
TGGGCAGTGCTAGAGTTAT -> GGGCAGTGCTAGAGTTATA
GACGACTCGCCAGCAAGAC -> ACGACTCGCCAGCAAGACA
GGTGCCAATGTTCTAAGTC -> GTGCCAATGTTCTAAGTCA
ACCGGGGATAGCCATCGTC -> CCGGGGATAGCCATCGTCC
TGGGGCCTCCCACTCTTCG -> GGGGCCTCCCACTCTTCGC
CACTATGGCTAAGAAGACT -> ACTATGGCTAAGAAGACTA
GAGGGGAGTCCGGCGGGAA -> AGGGGAGTCCGGCGGGAAC
CTGCAAGTTAGGTAGCTTA -> TGCAAGTTAGGTAGCTTAT
GCCCGATGCTGGACGAAAG -> CCCGATGCTGGACGAAAGT
CAAGCATGTCGCAATCTTG -> AAGCATGTCGCAATCTTGG
ACACGATTCTTGTATTTTG -> CACGATTCTTGTATTTTGT
GTGGATATTAAGCGCACCA -> TGGATATTAAGCGCACCAC
TCGCCAGAGAAGATATTTG -> CGCCAGAGAAGATATTTGA
TTTCACACCTATTCCGCAG -> TTCACACCTATTCCGCAGG
CCCTAGTCCCCCCCATCAG -> CCTAGTCCCCCCCATCAGG
CGTTCAGGCCTATGATGAC -> GTTCAGGCCTATGATGACC
ATGTCACATGGCCGTTTTA -> TGTCACATGGCCGTTTTAA
AGCCATCGTCCCCGCATAG -> GCCATCGTCCCCGCATAGT
GTTCAAGCAATCTCGAACC -> TTCAAGCAATCTCGAACCT
TACGGATCCCATACGGCCA -> ACGGATCCCATACGGCCAA
AATACATGACCGGATGTGA -> ATACATGACCGGATGTGAA
GATGACCTTCCTATGCATG -> ATGACCTTCCTATGCATGG
CCTCCGGTGCCAATGTTCT -> CTCCGGTGCCAATGTTCTA
TATACGAGAGCGAGACATA -> ATACGAGAGCGAGACATAG
CTTACAATAGAACCGAATT -> TTACAATAGAACCGAATTC
AATGAGTCAGGAATGACCA -> ATGAGTCAGGAATGACCAC
CCCGCACCTTCCTATGCAT -> CCGCACCTTCCTATGCATG
CGGTTATCTACCTCAGTGA -> GGTTATCTACCTCAGTGAT
GGGATACGACGAGTCCTTC -> GGATACGACGAGTCCTTCT
TTGGACGTTCACGGGTCCC -> TGGACGTTCACGGGTCCCC
GAAGTCTTCCACGCGTATG -> AAGTCTTCCACGCGTATGC
AAACAATGGGCAGTGCTAG -> AACAATGGGCAGTGCTAGA
TACTAAAGGTAGCGCGCCG -> ACTAAAGGTAGCGCGCCGC
TAATATCTTGGCCACAGTC -> AATATCTTGGCCACAGTCC
CGAACTTTGATAGCTGAAC -> GAACTTTGATAGCTGAACA
TTTGTTCCTAACCGTTTGT -> TTGTTCCTAACCGTTTGTC
CGTCCGATCACATTCCTCA -> GTCCGATCACATTCCTCAG
GTCCGATCACATTCCTCAG -> TCCGATCACATTCCTCAGA
CAGCTGGGCTTATGCCTTT -> AGCTGGGCTTATGCCTTTA
TATGATACTAAGGGTGCAT -> ATGATACTAAGGGTGCATA
TCACGGGTCCCCGCACCTT -> CACGGGTCCCCGCACCTTC
AAGACAGGACACGATTCTT -> AGACAGGACACGATTCTTG
TAAGCTTGACTTGTTCGTT -> AAGCTTGACTTGTTCGTTA
ACCTTCTGAATTAAGGATA -> CCTTCTGAATTAAGGATAA
CTAGAGTTATATAGACGCA -> TAGAGTTATATAGACGCAT
CCGATAATCCCGAGACTGA -> CGATAATCCCGAGACTGAA
AGCATAGACTGTGTTCGCA -> GCATAGACTGTGTTCGCAC
TGCGGCCGCATACGAACTT -> GCGGCCGCATACGAACTTT
ACGAGTCTAGGCTTCCTCG -> CGAGTCTAGGCTTCCTCGT
AGAGCGAGACATAGCGGAG -> GAGCGAGACATAGCGGAGG
TGCGATCTAAGAACACGTG -> GCGATCTAAGAACACGTGT
TGGAAGGAGTAGTGATCGG -> GGAAGGAGTAGTGATCGGT
CTTCTGAAGACAGGACACG -> TTCTGAAGACAGGACACGA
TTAAGGATAACAGGCATCA -> TAAGGATAACAGGCATCAA
TGACTATCTCGGGGTATAA -> GACTATCTCGGGGTATAAG
CCGACGGTTATCTATTACA -> CGACGGTTATCTATTACAC
GGCTTGACATAAACACGTG -> GCTTGACATAAACACGTGA
AGAAGATATTTGATTGAAT -> GAAGATATTTGATTGAATT
GGAGCAGGAATCGAGACGG -> GAGCAGGAATCGAGACGGT
CTCGCATACACGGGCATGG -> TCGCATACACGGGCATGGA
TATTTTACCGGTTATCTAC -> ATTTTACCGGTTATCTACC
CCCAAATCCACTTGCTTTA -> CCAAATCCACTTGCTTTAC
AGCATTCACACATTGCCTA -> GCATTCACACATTGCCTAG
ACGCGTATGCCCTCGTCCG -> CGCGTATGCCCTCGTCCGA
TTATCTACCTCAGTGATTA -> TATCTACCTCAGTGATTAA
ACTGGATATCTAAAAACCC -> CTGGATATCTAAAAACCCA
GTGTGCGGAAGTACTTGGA -> TGTGCGGAAGTACTTGGAC
TTCCTATGCATGGAAGTCA -> TCCTATGCATGGAAGTCAT
ACGCATAGCAATCTTACAA -> CGCATAGCAATCTTACAAT
TAGCAATCTTACAATAGAA -> AGCAATCTTACAATAGAAC
CATTGCCTAGGTTTGTGAC -> ATTGCCTAGGTTTGTGACT
GGCCAAACCGATAATCCCG -> GCCAAACCGATAATCCCGA
TTTGTGGCATCTTGCGATA -> TTGTGGCATCTTGCGATAC
GAATTCTGGGCAGAGCTGG -> AATTCTGGGCAGAGCTGGT
CTATGGCTAAGAAGACTAG -> TATGGCTAAGAAGACTAGG
GAACCGGGGATAGCCATCG -> AACCGGGGATAGCCATCGT
CGCCCTGGATATCCTGGTT -> GCCCTGGATATCCTGGTTA
CGATCTAAGAACACGTGTC -> GATCTAAGAACACGTGTCG
CTGAATTAAGGATAACAGG -> TGAATTAAGGATAACAGGC
TGCGCCCTACCCCCGTGCT -> GCGCCCTACCCCCGTGCTG
AGACCGCTTGTTATCAGCG -> GACCGCTTGTTATCAGCGG
CTTGGCACGTATCTAACCG -> TTGGCACGTATCTAACCGG
CAATCGTACATGCATCCTA -> AATCGTACATGCATCCTAC
TTGTGACTACTAAAGGTAG -> TGTGACTACTAAAGGTAGC
TGGCACTATGGCTAAGAAG -> GGCACTATGGCTAAGAAGA
GTAAAACTCCTCGATAACG -> TAAAACTCCTCGATAACGA
TGTTCCTAACCGTTTGTCC -> GTTCCTAACCGTTTGTCCG
CTGGCGGTCAATTAATGCG -> TGGCGGTCAATTAATGCGT
TATGCATGGAAGCATTCAC -> ATGCATGGAAGCATTCACA
CGTTCACGGGTCCCCGCAC -> GTTCACGGGTCCCCGCACC
TAGTAGCCACCTTAACGCG -> AGTAGCCACCTTAACGCGT
TAACAGGCATCAAAGCTGG -> AACAGGCATCAAAGCTGGG
AGAGTTATATAGACGCATA -> GAGTTATATAGACGCATAG
TAGTGCCAGAGGTCTTCAA -> AGTGCCAGAGGTCTTCAAT
AAGCATGTCGCAATCTTGG -> AGCATGTCGCAATCTTGGC
TGCTTAGAAACACACCCCA -> GCTTAGAAACACACCCCAT
CGTGCGATTAATGGGGGCC -> GTGCGATTAATGGGGGCCC
AAGTTAGGTAGCTTATGAT -> AGTTAGGTAGCTTATGATC
AACACGTGTCGTAAAACTC -> ACACGTGTCGTAAAACTCC
GTCCTCCTTTGAGGGATAC -> TCCTCCTTTGAGGGATACG
ACTCGCCAGCAAGACACTG -> CTCGCCAGCAAGACACTGC
CCACTGGATATCTAAAAAC -> CACTGGATATCTAAAAACC
AGAAGTCTTCCACGCGTAT -> GAAGTCTTCCACGCGTATG
CATTTTCGTGGTTAGCCCG -> ATTTTCGTGGTTAGCCCGA
TCGGGTAACGACAATTTAG -> CGGGTAACGACAATTTAGT
CCTCCTTTGAGGGATACGA -> CTCCTTTGAGGGATACGAC
TTGAGGGATACGACGAGTC -> TGAGGGATACGACGAGTCC
CATGGAAGGAGTAGTGATC -> ATGGAAGGAGTAGTGATCG
GTTAATTCCAAGCTAGACC -> TTAATTCCAAGCTAGACCG
CAGACACCAGTGGCGGTGT -> AGACACCAGTGGCGGTGTA
GAAGACTAGGAACACCACT -> AAGACTAGGAACACCACTG
CCTAACCGTTTGTCCGTAC -> CTAACCGTTTGTCCGTACA
ATGGGGGCCCTGTGGGCTG -> TGGGGGCCCTGTGGGCTGG
TGACATTAGACGACTCGCC -> GACATTAGACGACTCGCCA
TGCTAGAGTTATATAGACG -> GCTAGAGTTATATAGACGC
TTAGGTAGCTTATGATCTA -> TAGGTAGCTTATGATCTAC
ACAGGACACGATTCTTGTA -> CAGGACACGATTCTTGTAT
GAAGACAGGACACGATTCT -> AAGACAGGACACGATTCTT
TTACGCGACCGCAACCGAT -> TACGCGACCGCAACCGATT
TGTCGCAATCTTGGCACGT -> GTCGCAATCTTGGCACGTA
CGGTGTATTAGTAGCCACC -> GGTGTATTAGTAGCCACCT
GTTGTACAATTGCCTAGGG -> TTGTACAATTGCCTAGGGT
ACGACGAGTCCTTCTGAAG -> CGACGAGTCCTTCTGAAGA
CGGGGAGCAGGAATCGAGA -> GGGGAGCAGGAATCGAGAC
GAATGACCACTATTTTACC -> AATGACCACTATTTTACCG
TGTATTTTGTTCCTAACCG -> GTATTTTGTTCCTAACCGT
GCATCAAAGCTGGGGCCTC -> CATCAAAGCTGGGGCCTCC
GGAGTCCGGCGGGAACTCA -> GAGTCCGGCGGGAACTCAA
TCCTCGTAGTGGATATTAA -> CCTCGTAGTGGATATTAAG
CGACGGTTATCTATTACAC -> GACGGTTATCTATTACACC
CATGGAAGTCATTTTCGTG -> ATGGAAGTCATTTTCGTGG
CACAGTATGCTGAGTCGTC -> ACAGTATGCTGAGTCGTCA
GTTTAATTGTTAGTTCATC -> TTTAATTGTTAGTTCATCG
CGCACCACGCCAATTGACA -> GCACCACGCCAATTGACAT
CAGGGTGGCGTGGGAGAAT -> AGGGTGGCGTGGGAGAATC
TTCATGAAGTACTTGGACG -> TCATGAAGTACTTGGACGT
ATCTAAAAACCCAAATCCA -> TCTAAAAACCCAAATCCAC
AGACAATACTCGGGTACTG -> GACAATACTCGGGTACTGG
CGATTCTTGTATTTTGTTC -> GATTCTTGTATTTTGTTCC
TATTAAGCGCACCACGCCA -> ATTAAGCGCACCACGCCAA
TTGCGTATACGAGAGCGAG -> TGCGTATACGAGAGCGAGA
TATCTTGGCCACAGTCCAC -> ATCTTGGCCACAGTCCACC
ACGCTAGGTTTTGTGGCAT -> CGCTAGGTTTTGTGGCATC
AGTACTTGGACGTTCATTA -> GTACTTGGACGTTCATTAT
ATGCCGCTGGCGGTCAATT -> TGCCGCTGGCGGTCAATTA
CCACCTTAACGCGTTCCAA -> CACCTTAACGCGTTCCAAT
GGGCATGGATTGCGATCTA -> GGCATGGATTGCGATCTAA
CACATTGCCTAGGTTTGTG -> ACATTGCCTAGGTTTGTGA
ATGCGCCCTACCCCCGTGC -> TGCGCCCTACCCCCGTGCT
CGCCAGAGAAGATATTTGA -> GCCAGAGAAGATATTTGAT
TGGTTATGTCACATGGCCG -> GGTTATGTCACATGGCCGT
TGCCTAGGGTACCGACGGT -> GCCTAGGGTACCGACGGTT
ACGGCAAATGCCGCTGGCG -> CGGCAAATGCCGCTGGCGG
GGGAGAATCGGGTAACGAC -> GGAGAATCGGGTAACGACA
AAATCCACTTGCTTTACCG -> AATCCACTTGCTTTACCGT
TGAAGTACTTGGACGTTCA -> GAAGTACTTGGACGTTCAT
GAACACGTGTCGTAAAACT -> AACACGTGTCGTAAAACTC
CCCCCATCAGGGTGGCGTG -> CCCCATCAGGGTGGCGTGG
TGAACCGGGGATAGCCATC -> GAACCGGGGATAGCCATCG
GACTGTGTTCGCACCTACG -> ACTGTGTTCGCACCTACGC
GCCTGTTGTACAATTGCCT -> CCTGTTGTACAATTGCCTA
GTTTGTGACTACTAAAGGT -> TTTGTGACTACTAAAGGTA
GCCCAGAGCCAAGCCTCAA -> CCCAGAGCCAAGCCTCAAT
TCCAATGCGCCCTACCCCC -> CCAATGCGCCCTACCCCCG
CATGTTCCCCTCGGGGAGC -> ATGTTCCCCTCGGGGAGCA
CCCACTGAAGACAATACTC -> CCACTGAAGACAATACTCG
AATCGAGACGGTCAGGCGG -> ATCGAGACGGTCAGGCGGT
GATAACAGGCATCAAAGCT -> ATAACAGGCATCAAAGCTG
CAAAGCTGGGGCCTCCCAC -> AAAGCTGGGGCCTCCCACT
GACATAGCGGAGGGTTTCA -> ACATAGCGGAGGGTTTCAC
CCTTGAAGTGACTAATGAG -> CTTGAAGTGACTAATGAGT
GATCTAAGAACACGTGTCG -> ATCTAAGAACACGTGTCGT
GCCACAGTCCACCAGGCTG -> CCACAGTCCACCAGGCTGT
AGACGACTCGCCAGCAAGA -> GACGACTCGCCAGCAAGAC
GCAACCGATTTCAAGATGA -> CAACCGATTTCAAGATGAC
TGCGCCCTGGATATCCTGG -> GCGCCCTGGATATCCTGGT
ATTATAATATCGACCTTCC -> TTATAATATCGACCTTCCT
ACATGGCCGTTTTAACCGC -> CATGGCCGTTTTAACCGCA
AACGATGCGGCCGCATACG -> ACGATGCGGCCGCATACGA
AAGCGCACCACGCCAATTG -> AGCGCACCACGCCAATTGA
ATCTTAATATCTTGGCCAC -> TCTTAATATCTTGGCCACA
TGGAAGTCATTTTCGTGGT -> GGAAGTCATTTTCGTGGTT
GCAGAATAAGAGAACTTGG -> CAGAATAAGAGAACTTGGT
GAACCACACTTACGCGACC -> AACCACACTTACGCGACCG
TCACATGGCCGTTTTAACC -> CACATGGCCGTTTTAACCG
GATTAATAGTGCCAGAGGT -> ATTAATAGTGCCAGAGGTC
CACTAGAACCACACTTACG -> ACTAGAACCACACTTACGC
CAATAGAACCGAATTCTGG -> AATAGAACCGAATTCTGGG
TCCGGCGGGAACTCAAGTG -> CCGGCGGGAACTCAAGTGA
ATGTTGGGTACCAGAGGGG -> TGTTGGGTACCAGAGGGGA
GACGAGTCTAGGCTTCCTC -> ACGAGTCTAGGCTTCCTCG
TTATGATCTACTACGGATC -> TATGATCTACTACGGATCC
TCGTCAGCCGCGCTGTTTA -> CGTCAGCCGCGCTGTTTAC
ATGACCGGATGTGAAAATG -> TGACCGGATGTGAAAATGT
AGTGATTAATAGTGCCAGA -> GTGATTAATAGTGCCAGAG
GTTAGCTCACGGCAAATGC -> TTAGCTCACGGCAAATGCC
GGTAGCTTATGATCTACTA -> GTAGCTTATGATCTACTAC
CTATGCATGGAAGTCATTT -> TATGCATGGAAGTCATTTT
GACTGTCCCACACAGTATG -> ACTGTCCCACACAGTATGC
TTGCGCGCATGCCGCGGCT -> TGCGCGCATGCCGCGGCTT
GGATTGCGATCTAAGAACA -> GATTGCGATCTAAGAACAC
TTAGTGAATTGCGCGCATG -> TAGTGAATTGCGCGCATGC
TAGACTGTGTTCGCACCTA -> AGACTGTGTTCGCACCTAC
TACATGACCGGATGTGAAA -> ACATGACCGGATGTGAAAA
CACCCCATCCTCAGAGTTA -> ACCCCATCCTCAGAGTTAG
TGCGTAGAAGTCTTCCACG -> GCGTAGAAGTCTTCCACGC
CATCTTAATATCTTGGCCA -> ATCTTAATATCTTGGCCAC
AGTGGCGGTGTATTAGTAG -> GTGGCGGTGTATTAGTAGC
GGATGTGAAAATGTACCTA -> GATGTGAAAATGTACCTAC
ACAGAGCTGAGCCGTGTTA -> CAGAGCTGAGCCGTGTTAG
GGGCCCTGTGGGCTGGGGT -> GGCCCTGTGGGCTGGGGTC
CCGTCCGATCACATTCCTC -> CGTCCGATCACATTCCTCA
CCCTGGATATCCTGGTTAT -> CCTGGATATCCTGGTTATG
TGACCTTGAAGTGACTAAT -> GACCTTGAAGTGACTAATG
ATCAGCGGAGGTTGCGACC -> TCAGCGGAGGTTGCGACCC
TCAGACACCAGTGGCGGTG -> CAGACACCAGTGGCGGTGT
CTTAATATCTTGGCCACAG -> TTAATATCTTGGCCACAGT
GCTAGGTTTTGTGGCATCT -> CTAGGTTTTGTGGCATCTT
TCTGAATTAAGGATAACAG -> CTGAATTAAGGATAACAGG
GCGCAGTGTATTCGGCAGA -> CGCAGTGTATTCGGCAGAA
AGCAATCTTACAATAGAAC -> GCAATCTTACAATAGAACC
GGTGGCGTGGGAGAATCGG -> GTGGCGTGGGAGAATCGGG
TTGCATGTTCCCCTCGGGG -> TGCATGTTCCCCTCGGGGA
ATCCTGGTTATGTCACATG -> TCCTGGTTATGTCACATGG
TATTAGAGCCTGTTGTACA -> ATTAGAGCCTGTTGTACAA
ACCGCAACCGATTTCAAGA -> CCGCAACCGATTTCAAGAT
GAATTTTGCATGTTCCCCT -> AATTTTGCATGTTCCCCTC
TATGATGACCTTCCTATGC -> ATGATGACCTTCCTATGCA
AATAGAACCGAATTCTGGG -> ATAGAACCGAATTCTGGGC
TGGACGAAAGTCTCGCATA -> GGACGAAAGTCTCGCATAC
CCATCCTCAGAGTTAGGTT -> CATCCTCAGAGTTAGGTTA
ACAGGCATCAAAGCTGGGG -> CAGGCATCAAAGCTGGGGC
AATCTCGAACCTTCCTATG -> ATCTCGAACCTTCCTATGC
CGGCTTGACATAAACACGT -> GGCTTGACATAAACACGTG
TACCTCAGTGATTAATAGT -> ACCTCAGTGATTAATAGTG
CCTATGCATGGAAGCATTC -> CTATGCATGGAAGCATTCA
CATGTCGCAATCTTGGCAC -> ATGTCGCAATCTTGGCACG
CATGTTGGGTACCAGAGGG -> ATGTTGGGTACCAGAGGGG
TACGTGTGCGGAAGTACTT -> ACGTGTGCGGAAGTACTTG
AAATACCACACTAGAACCA -> AATACCACACTAGAACCAC
CGTGACGCCGTACCACCGT -> GTGACGCCGTACCACCGTC
CTTCCTATGCATGGAAGGA -> TTCCTATGCATGGAAGGAG
CCTTAACGCGTTCCAATGC -> CTTAACGCGTTCCAATGCG
AAAAACCCAAATCCACTTG -> AAAACCCAAATCCACTTGC
TATAATATCGACCTTCCTA -> ATAATATCGACCTTCCTAT
CCCCCCATCAGGGTGGCGT -> CCCCCATCAGGGTGGCGTG
GAACAGAGCTGAGCCGTGT -> AACAGAGCTGAGCCGTGTT
AGCCAGAAGTACTTGGACG -> GCCAGAAGTACTTGGACGT
AGTCATTTTCGTGGTTAGC -> GTCATTTTCGTGGTTAGCC
GTGGGCTGGGGTCTGTGCT -> TGGGCTGGGGTCTGTGCTT
CGACAATTTAGTGAATTGC -> GACAATTTAGTGAATTGCG
CGCCAGCAAGACACTGCAA -> GCCAGCAAGACACTGCAAG
CAATCTTGGCACGTATCTA -> AATCTTGGCACGTATCTAA
ATTCCAAGCTAGACCGCTT -> TTCCAAGCTAGACCGCTTG
CCTGGGAGTAATACATGAC -> CTGGGAGTAATACATGACC
AGGTTTTGTGGCATCTTGC -> GGTTTTGTGGCATCTTGCG
TAATGGGGGCCCTGTGGGC -> AATGGGGGCCCTGTGGGCT
TTCAATCGTACATGCATCC -> TCAATCGTACATGCATCCT
AGTACTTGGACGTTCAAGC -> GTACTTGGACGTTCAAGCA
TGAGTCAGACCTTCTGAAT -> GAGTCAGACCTTCTGAATT
TACTTGGACGTTCACGGGT -> ACTTGGACGTTCACGGGTC
GGAGGGTTTCACACCTATT -> GAGGGTTTCACACCTATTC
CAATGCGCCCTACCCCCGT -> AATGCGCCCTACCCCCGTG
CCTGTGGGCTGGGGTCTGT -> CTGTGGGCTGGGGTCTGTG
GCATGTTCCCCTCGGGGAG -> CATGTTCCCCTCGGGGAGC
GGTTATCTATTACACCAAG -> GTTATCTATTACACCAAGC
TATCTATTACACCAAGCAT -> ATCTATTACACCAAGCATG
TAGACGACTCGCCAGCAAG -> AGACGACTCGCCAGCAAGA
GTTATCAGCGGAGGTTGCG -> TTATCAGCGGAGGTTGCGA
CTGAGTCGTCAGCCGCGCT -> TGAGTCGTCAGCCGCGCTG
CGGTGGTAGAAATACCACA -> GGTGGTAGAAATACCACAC
CGTATACGAGAGCGAGACA -> GTATACGAGAGCGAGACAT
GCATGGAAGTCATTTTCGT -> CATGGAAGTCATTTTCGTG
GCGGAGGTTGCGACCCACT -> CGGAGGTTGCGACCCACTG
TTCACACATTGCCTAGGTT -> TCACACATTGCCTAGGTTT
CCCCGCACCTTCCTATGCA -> CCCGCACCTTCCTATGCAT
ATCGTACATGCATCCTACC -> TCGTACATGCATCCTACCC
CCTACATGACCTTGAAGTG -> CTACATGACCTTGAAGTGA
TGCGATACGCGGAGGGGTT -> GCGATACGCGGAGGGGTTT
TCGAGACGGTCAGGCGGTT -> CGAGACGGTCAGGCGGTTC
ATGCATGGAAGCCATCTTA -> TGCATGGAAGCCATCTTAA
TAGCGCGCCGCAGCTAAGC -> AGCGCGCCGCAGCTAAGCT
TGGAAGCATTCACACATTG -> GGAAGCATTCACACATTGC
TTTGAGGGATACGACGAGT -> TTGAGGGATACGACGAGTC
TTAATATCTTGGCCACAGT -> TAATATCTTGGCCACAGTC
TTCGCACCTACGCAGTGTT -> TCGCACCTACGCAGTGTTC
AACCACACTTACGCGACCG -> ACCACACTTACGCGACCGC
CGGTTATCTATTACACCAA -> GGTTATCTATTACACCAAG
GGCATGGATTGCGATCTAA -> GCATGGATTGCGATCTAAG
AGGAATGACCACTATTTTA -> GGAATGACCACTATTTTAC
GGATATCTAAAAACCCAAA -> GATATCTAAAAACCCAAAT
ATGGCCGTTTTAACCGCAA -> TGGCCGTTTTAACCGCAAG
GATCCCATACGGCCAAACC -> ATCCCATACGGCCAAACCG
CCGGACAACTATGATACTA -> CGGACAACTATGATACTAA
ATCTTGGCACGTATCTAAC -> TCTTGGCACGTATCTAACC
ATAGCTGAACAGAGCTGAG -> TAGCTGAACAGAGCTGAGC
ATACGGCCAAACCGATAAT -> TACGGCCAAACCGATAATC
ATATCGACCTTCCTATGCA -> TATCGACCTTCCTATGCAT
AAGCGAAGTACTTGGACGT -> AGCGAAGTACTTGGACGTT
GTTCACGGGTCCCCGCACC -> TTCACGGGTCCCCGCACCT
CTCGGGTACTGGCCCTGGG -> TCGGGTACTGGCCCTGGGA
CATCAGGGTGGCGTGGGAG -> ATCAGGGTGGCGTGGGAGA
TTGTACAATTGCCTAGGGT -> TGTACAATTGCCTAGGGTA
TACATGTTGGGTACCAGAG -> ACATGTTGGGTACCAGAGG
GTTTTGCGTACAGCTGGGC -> TTTTGCGTACAGCTGGGCT
CGCATACACGGGCATGGAT -> GCATACACGGGCATGGATT
TTCTAAGTCAGCACGAATC -> TCTAAGTCAGCACGAATCT
AATGCGCCCTACCCCCGTG -> ATGCGCCCTACCCCCGTGC
ACGATTCTTGTATTTTGTT -> CGATTCTTGTATTTTGTTC
TGAGTCAGGAATGACCACT -> GAGTCAGGAATGACCACTA
CTGGACGAAAGTCTCGCAT -> TGGACGAAAGTCTCGCATA
CGTCCGACTCGTCCTCCTT -> GTCCGACTCGTCCTCCTTT
ATCTCGAACCTTCCTATGC -> TCTCGAACCTTCCTATGCA
CGGCCGCATACGAACTTTG -> GGCCGCATACGAACTTTGA
CGCCCAGAGCCAAGCCTCA -> GCCCAGAGCCAAGCCTCAA
GGGCAGAGCTGGTCGCCCA -> GGCAGAGCTGGTCGCCCAG
GGTATAAGCGAAGTACTTG -> GTATAAGCGAAGTACTTGG
CGTACATGCATCCTACCCT -> GTACATGCATCCTACCCTC
AATACTCGGGTACTGGCCC -> ATACTCGGGTACTGGCCCT
TTGTATTTTGTTCCTAACC -> TGTATTTTGTTCCTAACCG
CAAGTGAGTCAGACCTTCT -> AAGTGAGTCAGACCTTCTG
TAAGGATAACAGGCATCAA -> AAGGATAACAGGCATCAAA
CGAATCTATTAGAGCCTGT -> GAATCTATTAGAGCCTGTT
CCGCAGGACGAGTCTAGGC -> CGCAGGACGAGTCTAGGCT
GACAGGACACGATTCTTGT -> ACAGGACACGATTCTTGTA
GGGTCTGTGCTTAGAAACA -> GGTCTGTGCTTAGAAACAC
ACTTGGTGACCGTGCGATT -> CTTGGTGACCGTGCGATTA
GGACGTTCATTATAATATC -> GACGTTCATTATAATATCG
TGCCAGAGGTCTTCAATCG -> GCCAGAGGTCTTCAATCGT
CGCGTATGCCCTCGTCCGA -> GCGTATGCCCTCGTCCGAC
GTGGTAGAAATACCACACT -> TGGTAGAAATACCACACTA
TACACGGGCATGGATTGCG -> ACACGGGCATGGATTGCGA
CTTCCTATGCATGGAAGTC -> TTCCTATGCATGGAAGTCA
TTCAAGCAATCTCGAACCT -> TCAAGCAATCTCGAACCTT
GCACCTACGCAGTGTTCCA -> CACCTACGCAGTGTTCCAG
GTCGGGGCGCAGTGTATTC -> TCGGGGCGCAGTGTATTCG
AGACTAGGAACACCACTGG -> GACTAGGAACACCACTGGA
ACCCACTGAAGACAATACT -> CCCACTGAAGACAATACTC
TACGCGGAGGGGTTTAATT -> ACGCGGAGGGGTTTAATTG
GTGTTCCAGTTTCGTCGGG -> TGTTCCAGTTTCGTCGGGG
TGCCAATGTTCTAAGTCAG -> GCCAATGTTCTAAGTCAGC
TCCGTACATGTTGGGTACC -> CCGTACATGTTGGGTACCA
GGAGGGGTTTAATTGTTAG -> GAGGGGTTTAATTGTTAGT
ATCGGGTAACGACAATTTA -> TCGGGTAACGACAATTTAG
ACAATTGCCTAGGGTACCG -> CAATTGCCTAGGGTACCGA
ACCCTCCGGTGCCAATGTT -> CCCTCCGGTGCCAATGTTC
ACATGCATCCTACCCTCCG -> CATGCATCCTACCCTCCGG
TCCCATACGGCCAAACCGA -> CCCATACGGCCAAACCGAT
TCCTCCTTTGAGGGATACG -> CCTCCTTTGAGGGATACGA
TTCCTCGTAGTGGATATTA -> TCCTCGTAGTGGATATTAA
TAGCCCGATGCTGGACGAA -> AGCCCGATGCTGGACGAAA
TCAGGGTGGCGTGGGAGAA -> CAGGGTGGCGTGGGAGAAT
CTCGTCCGACTCGTCCTCC -> TCGTCCGACTCGTCCTCCT
TGCGGAAGTACTTGGACGT -> GCGGAAGTACTTGGACGTT
CAGTGCTAGAGTTATATAG -> AGTGCTAGAGTTATATAGA
GGGGTCTGTGCTTAGAAAC -> GGGTCTGTGCTTAGAAACA
AGCTGGTCGCCCAGAGCCA -> GCTGGTCGCCCAGAGCCAA
ATGGAAGCATTCACACATT -> TGGAAGCATTCACACATTG
AAACTCCTCGATAACGATG -> AACTCCTCGATAACGATGC
GTGAAAATGTACCTACATG -> TGAAAATGTACCTACATGA
ATTGCCTAGGTTTGTGACT -> TTGCCTAGGTTTGTGACTA
TCTAGGCTTCCTCGTAGTG -> CTAGGCTTCCTCGTAGTGG
GCCTCCCACTCTTCGCTGA -> CCTCCCACTCTTCGCTGAC
GTCTTCCACGCGTATGCCC -> TCTTCCACGCGTATGCCCT
CCAGTTTCGTCGGGGCGCA -> CAGTTTCGTCGGGGCGCAG
ACAATTTAGTGAATTGCGC -> CAATTTAGTGAATTGCGCG
GCACCTTCCTATGCATGGA -> CACCTTCCTATGCATGGAA
AGGCTGTATATTGCGACCT -> GGCTGTATATTGCGACCTT
ACACATTGCCTAGGTTTGT -> CACATTGCCTAGGTTTGTG
AGAACACGTGTCGTAAAAC -> GAACACGTGTCGTAAAACT
ATTAATGGGGGCCCTGTGG -> TTAATGGGGGCCCTGTGGG
GCAGGAATCGAGACGGTCA -> CAGGAATCGAGACGGTCAG
CACGTGACGCCGTACCACC -> ACGTGACGCCGTACCACCG
GTCGGTGGTAGAAATACCA -> TCGGTGGTAGAAATACCAC
TACGAACTTTGATAGCTGA -> ACGAACTTTGATAGCTGAA
ATTCACACATTGCCTAGGT -> TTCACACATTGCCTAGGTT
AGAAACACACCCCATCCTC -> GAAACACACCCCATCCTCA
GGCGCAGTGTATTCGGCAG -> GCGCAGTGTATTCGGCAGA
AACACACCCCATCCTCAGA -> ACACACCCCATCCTCAGAG
CCGCTTGTTATCAGCGGAG -> CGCTTGTTATCAGCGGAGG
GATAACGATGCGGCCGCAT -> ATAACGATGCGGCCGCATA
GGTCAGGCGGTTCAAAAAC -> GTCAGGCGGTTCAAAAACA
TCCTATGCATGGAAGTCAT -> CCTATGCATGGAAGTCATT
ACCACTATTTTACCGGTTA -> CCACTATTTTACCGGTTAT
CACGATTCTTGTATTTTGT -> ACGATTCTTGTATTTTGTT
CAGGACACGATTCTTGTAT -> AGGACACGATTCTTGTATT
CGATGCTGGACGAAAGTCT -> GATGCTGGACGAAAGTCTC
TGGTAGAAATACCACACTA -> GGTAGAAATACCACACTAG
ATGACCTTGAAGTGACTAA -> TGACCTTGAAGTGACTAAT
ATCTCGGGGTATAAGCGAA -> TCTCGGGGTATAAGCGAAG
CACAGTCCACCAGGCTGTA -> ACAGTCCACCAGGCTGTAT
ACGTTCAGGCCTATGATGA -> CGTTCAGGCCTATGATGAC
GGAATCGAGACGGTCAGGC -> GAATCGAGACGGTCAGGCG
CCCGAGACTGAACCGGGGA -> CCGAGACTGAACCGGGGAT
GTATTAGTAGCCACCTTAA -> TATTAGTAGCCACCTTAAC
AGGACGAGTCTAGGCTTCC -> GGACGAGTCTAGGCTTCCT
GACTCGCCAGCAAGACACT -> ACTCGCCAGCAAGACACTG
TGGATATCCTGGTTATGTC -> GGATATCCTGGTTATGTCA
AGCTTGACTTGTTCGTTAA -> GCTTGACTTGTTCGTTAAT
GCTGAACAGAGCTGAGCCG -> CTGAACAGAGCTGAGCCGT
CTTTGCGTATACGAGAGCG -> TTTGCGTATACGAGAGCGA
TTAGCTCACGGCAAATGCC -> TAGCTCACGGCAAATGCCG
CGCCCTACCCCCGTGCTGC -> GCCCTACCCCCGTGCTGCG
GTATTCGGCAGAATAAGAG -> TATTCGGCAGAATAAGAGA
ACCTATTCCGCAGGACGAG -> CCTATTCCGCAGGACGAGT
ACGGCCAAACCGATAATCC -> CGGCCAAACCGATAATCCC
GATTCTTGTATTTTGTTCC -> ATTCTTGTATTTTGTTCCT
AATTGCCTAGGGTACCGAC -> ATTGCCTAGGGTACCGACG
GAGAATCGGGTAACGACAA -> AGAATCGGGTAACGACAAT
CTTACGCGACCGCAACCGA -> TTACGCGACCGCAACCGAT
GTTAGGTAGCTTATGATCT -> TTAGGTAGCTTATGATCTA
AGAGCTGAGCCGTGTTAGC -> GAGCTGAGCCGTGTTAGCT
GCTGGGCTTATGCCTTTAC -> CTGGGCTTATGCCTTTACG
TCTTCAATCGTACATGCAT -> CTTCAATCGTACATGCATC
GAAGCATTCACACATTGCC -> AAGCATTCACACATTGCCT
TAGTGGATATTAAGCGCAC -> AGTGGATATTAAGCGCACC
TAACGCGTTCCAATGCGCC -> AACGCGTTCCAATGCGCCC
ACCGGATGTGAAAATGTAC -> CCGGATGTGAAAATGTACC
CTCTTCGCTGACTATCTCG -> TCTTCGCTGACTATCTCGG
CCGCACCTTCCTATGCATG -> CGCACCTTCCTATGCATGG
CCTATGATGACCTTCCTAT -> CTATGATGACCTTCCTATG
CTAGGTTTGTGACTACTAA -> TAGGTTTGTGACTACTAAA
GGTTATTGTCCATGGCGCT -> GTTATTGTCCATGGCGCTT
TTCCTATGCATGGAAGCAT -> TCCTATGCATGGAAGCATT
ACCACTGGATATCTAAAAA -> CCACTGGATATCTAAAAAC
GTTTTGTGGCATCTTGCGA -> TTTTGTGGCATCTTGCGAT
GTACCGACGGTTATCTATT -> TACCGACGGTTATCTATTA
TTACAATAGAACCGAATTC -> TACAATAGAACCGAATTCT
AAGAGAACTTGGTGACCGT -> AGAGAACTTGGTGACCGTG
TCTTGGCCACAGTCCACCA -> CTTGGCCACAGTCCACCAG
TCGCTGACTATCTCGGGGT -> CGCTGACTATCTCGGGGTA
ATACATGACCGGATGTGAA -> TACATGACCGGATGTGAAA
TAGGGTACCGACGGTTATC -> AGGGTACCGACGGTTATCT
TTGTTATCAGCGGAGGTTG -> TGTTATCAGCGGAGGTTGC
ACCAAGCATGTCGCAATCT -> CCAAGCATGTCGCAATCTT
AGTCCCCCCCATCAGGGTG -> GTCCCCCCCATCAGGGTGG
GATATTTGATTGAATTTTG -> ATATTTGATTGAATTTTGC
ATTGTTAGTTCATCGCCAG -> TTGTTAGTTCATCGCCAGA
CTGTGTTCGCACCTACGCA -> TGTGTTCGCACCTACGCAG
TTTCAAGATGACTGTCCCA -> TTCAAGATGACTGTCCCAC
AGTCCGGCGGGAACTCAAG -> GTCCGGCGGGAACTCAAGT
GATAGCTGAACAGAGCTGA -> ATAGCTGAACAGAGCTGAG
ACCGACGGTTATCTATTAC -> CCGACGGTTATCTATTACA
GACTAATGAGTCAGGAATG -> ACTAATGAGTCAGGAATGA
TACCTACATGACCTTGAAG -> ACCTACATGACCTTGAAGT
ACACAGTATGCTGAGTCGT -> CACAGTATGCTGAGTCGTC
CCTTTACGTGTGCGGAAGT -> CTTTACGTGTGCGGAAGTA
TCGACCTTCCTATGCATGG -> CGACCTTCCTATGCATGGA
CACGGGTCCCCGCACCTTC -> ACGGGTCCCCGCACCTTCC
TGGCCACAGTCCACCAGGC -> GGCCACAGTCCACCAGGCT
ATAAGAGAACTTGGTGACC -> TAAGAGAACTTGGTGACCG
GCGACCTTAATACGCTAGG -> CGACCTTAATACGCTAGGT
TACTAAGGGTGCATATGTC -> ACTAAGGGTGCATATGTCT
TGCGTACAGCTGGGCTTAT -> GCGTACAGCTGGGCTTATG
TTGGGTACCAGAGGGGAGT -> TGGGTACCAGAGGGGAGTC
TTCTTGTATTTTGTTCCTA -> TCTTGTATTTTGTTCCTAA
GGAAGCATTCACACATTGC -> GAAGCATTCACACATTGCC
TCTGGGCAGAGCTGGTCGC -> CTGGGCAGAGCTGGTCGCC
TCCTGGTTATGTCACATGG -> CCTGGTTATGTCACATGGC
GTCAGCCGCGCTGTTTACT -> TCAGCCGCGCTGTTTACTC
CTACGCAGTGTTCCAGTTT -> TACGCAGTGTTCCAGTTTC
CGTCGGGGCGCAGTGTATT -> GTCGGGGCGCAGTGTATTC
TAGCTCACGGCAAATGCCG -> AGCTCACGGCAAATGCCGC
ACGAACTTTGATAGCTGAA -> CGAACTTTGATAGCTGAAC
AGTGAGTCAGACCTTCTGA -> GTGAGTCAGACCTTCTGAA
GCCCTGTGGGCTGGGGTCT -> CCCTGTGGGCTGGGGTCTG
ACATGTTGGGTACCAGAGG -> CATGTTGGGTACCAGAGGG
CTTGGACGTTCATTATAAT -> TTGGACGTTCATTATAATA
CTGGCCCTGGGAGTAATAC -> TGGCCCTGGGAGTAATACA
TAGCTGAACAGAGCTGAGC -> AGCTGAACAGAGCTGAGCC
AGAGAAGATATTTGATTGA -> GAGAAGATATTTGATTGAA
AAACACGTGACGCCGTACC -> AACACGTGACGCCGTACCA
TACCGGTTATCTACCTCAG -> ACCGGTTATCTACCTCAGT
ACACCCCATCCTCAGAGTT -> CACCCCATCCTCAGAGTTA
GGAAGCCATCTTAATATCT -> GAAGCCATCTTAATATCTT
CCTCGTAGTGGATATTAAG -> CTCGTAGTGGATATTAAGC
CTTAGAAACACACCCCATC -> TTAGAAACACACCCCATCC
TTTGTCCGTACATGTTGGG -> TTGTCCGTACATGTTGGGT
ATGGAAGTCATTTTCGTGG -> TGGAAGTCATTTTCGTGGT
ACACCAAGCATGTCGCAAT -> CACCAAGCATGTCGCAATC
AGCAATCTCGAACCTTCCT -> GCAATCTCGAACCTTCCTA
GGCGCTTGCCCTAGTCCCC -> GCGCTTGCCCTAGTCCCCC
CCAAGCATGTCGCAATCTT -> CAAGCATGTCGCAATCTTG
ATAGTTAGTCGGTGGTAGA -> TAGTTAGTCGGTGGTAGAA
CAGAGGTCTTCAATCGTAC -> AGAGGTCTTCAATCGTACA
GTCAGCACGAATCTATTAG -> TCAGCACGAATCTATTAGA
GCCGCGGCTTGACATAAAC -> CCGCGGCTTGACATAAACA
TGATAGCTGAACAGAGCTG -> GATAGCTGAACAGAGCTGA
GACACTGCAAGTTAGGTAG -> ACACTGCAAGTTAGGTAGC
TTTCGTCGGGGCGCAGTGT -> TTCGTCGGGGCGCAGTGTA
GTCAGGCGGTTCAAAAACA -> TCAGGCGGTTCAAAAACAA
AGATATTTGATTGAATTTT -> GATATTTGATTGAATTTTG
ATACGACGAGTCCTTCTGA -> TACGACGAGTCCTTCTGAA
CTTGCCCTAGTCCCCCCCA -> TTGCCCTAGTCCCCCCCAT
CCTGTTGTACAATTGCCTA -> CTGTTGTACAATTGCCTAG
TTTTCGTGGTTAGCCCGAT -> TTTCGTGGTTAGCCCGATG
CATAGACTGTGTTCGCACC -> ATAGACTGTGTTCGCACCT
ACGTTCACGGGTCCCCGCA -> CGTTCACGGGTCCCCGCAC
CTAAGGGTGCATATGTCTT -> TAAGGGTGCATATGTCTTT
GCGCATGCCGCGGCTTGAC -> CGCATGCCGCGGCTTGACA
CATCTTGCGATACGCGGAG -> ATCTTGCGATACGCGGAGG
CATCCTACCCTCCGGTGCC -> ATCCTACCCTCCGGTGCCA
CTTGGCCACAGTCCACCAG -> TTGGCCACAGTCCACCAGG
ATCAGGGTGGCGTGGGAGA -> TCAGGGTGGCGTGGGAGAA
AATATCTTGGCCACAGTCC -> ATATCTTGGCCACAGTCCA
GCCTATGATGACCTTCCTA -> CCTATGATGACCTTCCTAT
GTCCCCCCCATCAGGGTGG -> TCCCCCCCATCAGGGTGGC
TAATACGCTAGGTTTTGTG -> AATACGCTAGGTTTTGTGG
GCATACGAACTTTGATAGC -> CATACGAACTTTGATAGCT
CACCGTCCGATCACATTCC -> ACCGTCCGATCACATTCCT
GACCTTAATACGCTAGGTT -> ACCTTAATACGCTAGGTTT
GCCAAGCCTCAATGTGTAG -> CCAAGCCTCAATGTGTAGT
TCCAAGCTAGACCGCTTGT -> CCAAGCTAGACCGCTTGTT
TCTTGTATTTTGTTCCTAA -> CTTGTATTTTGTTCCTAAC
GAATCGAGACGGTCAGGCG -> AATCGAGACGGTCAGGCGG
CACCTACGCAGTGTTCCAG -> ACCTACGCAGTGTTCCAGT
GGGTATAAGCGAAGTACTT -> GGTATAAGCGAAGTACTTG
ACCAGTGGCGGTGTATTAG -> CCAGTGGCGGTGTATTAGT
AGTCGTCAGCCGCGCTGTT -> GTCGTCAGCCGCGCTGTTT
GAACACCACTGGATATCTA -> AACACCACTGGATATCTAA
GGAGGTTGCGACCCACTGA -> GAGGTTGCGACCCACTGAA
ACGAGTCCTTCTGAAGACA -> CGAGTCCTTCTGAAGACAG
AAGACAATACTCGGGTACT -> AGACAATACTCGGGTACTG
AGCCACCTTAACGCGTTCC -> GCCACCTTAACGCGTTCCA
AGACACCAGTGGCGGTGTA -> GACACCAGTGGCGGTGTAT
TAGGTTTTGTGGCATCTTG -> AGGTTTTGTGGCATCTTGC
CAAATGCCGCTGGCGGTCA -> AAATGCCGCTGGCGGTCAA
CATGAAGTACTTGGACGTT -> ATGAAGTACTTGGACGTTC
TGTTAGTTCATCGCCAGAG -> GTTAGTTCATCGCCAGAGA
TCCGCAGGACGAGTCTAGG -> CCGCAGGACGAGTCTAGGC
GTGCGATTAATGGGGGCCC -> TGCGATTAATGGGGGCCCT
CGAGACGGTCAGGCGGTTC -> GAGACGGTCAGGCGGTTCA
CAAACCGATAATCCCGAGA -> AAACCGATAATCCCGAGAC
GGGCCTCCCACTCTTCGCT -> GGCCTCCCACTCTTCGCTG
CCGTTTGTCCGTACATGTT -> CGTTTGTCCGTACATGTTG
GTTCCCCTCGGGGAGCAGG -> TTCCCCTCGGGGAGCAGGA
TAAGAGAACTTGGTGACCG -> AAGAGAACTTGGTGACCGT
CTGGTTATGTCACATGGCC -> TGGTTATGTCACATGGCCG
AAAACCCAAATCCACTTGC -> AAACCCAAATCCACTTGCT
CGGACAACTATGATACTAA -> GGACAACTATGATACTAAG
GAGACATAGCGGAGGGTTT -> AGACATAGCGGAGGGTTTC
TGCAAGTTAGGTAGCTTAT -> GCAAGTTAGGTAGCTTATG
AATCTTACAATAGAACCGA -> ATCTTACAATAGAACCGAA
TTTGCGTACAGCTGGGCTT -> TTGCGTACAGCTGGGCTTA
AATGCCGCTGGCGGTCAAT -> ATGCCGCTGGCGGTCAATT
TGAACAGAGCTGAGCCGTG -> GAACAGAGCTGAGCCGTGT
TGACTTGTTCGTTAATTCC -> GACTTGTTCGTTAATTCCA
TATCTACCTCAGTGATTAA -> ATCTACCTCAGTGATTAAT
ATAGCAATCTTACAATAGA -> TAGCAATCTTACAATAGAA
TCCCCCCCATCAGGGTGGC -> CCCCCCCATCAGGGTGGCG
AGTAGCCACCTTAACGCGT -> GTAGCCACCTTAACGCGTT
CGATTAATGGGGGCCCTGT -> GATTAATGGGGGCCCTGTG
ACAGTATGCTGAGTCGTCA -> CAGTATGCTGAGTCGTCAG
GTGGGAGAATCGGGTAACG -> TGGGAGAATCGGGTAACGA
CGGTGCCAATGTTCTAAGT -> GGTGCCAATGTTCTAAGTC
CAGAGCTGAGCCGTGTTAG -> AGAGCTGAGCCGTGTTAGC
CGCATAGTTAGTCGGTGGT -> GCATAGTTAGTCGGTGGTA
AACACGTGACGCCGTACCA -> ACACGTGACGCCGTACCAC
ACGGTTATCTATTACACCA -> CGGTTATCTATTACACCAA
ATGTTCCCCTCGGGGAGCA -> TGTTCCCCTCGGGGAGCAG
GCATGCCGCGGCTTGACAT -> CATGCCGCGGCTTGACATA
GGACGTTCAAGCAATCTCG -> GACGTTCAAGCAATCTCGA
AAAGTCTCGCATACACGGG -> AAGTCTCGCATACACGGGC