GTCATCCTGTG -> TCATCCTGTGG
TCATCCTGTGG -> CATCCTGTGGG
CATCCTGTGGG -> ATCCTGTGGGC
ATCCTGTGGGC -> TCCTGTGGGCT
TCCTGTGGGCT -> CCTGTGGGCTC
CCTGTGGGCTC -> CTGTGGGCTCG
CTGTGGGCTCG -> TGTGGGCTCGA
TGTGGGCTCGA -> GTGGGCTCGAA
GTGGGCTCGAA -> TGGGCTCGAAC
TGGGCTCGAAC -> GGGCTCGAACA
GGGCTCGAACA -> GGCTCGAACAC
GGCTCGAACAC -> GCTCGAACACA
GCTCGAACACA -> CTCGAACACAC
CTCGAACACAC -> TCGAACACACC
TCGAACACACC -> CGAACACACCA
CGAACACACCA -> GAACACACCAC
GAACACACCAC -> AACACACCACA
AACACACCACA -> ACACACCACAA
ACACACCACAA -> CACACCACAAA
CACACCACAAA -> ACACCACAAAT
ACACCACAAAT -> CACCACAAATG
CACCACAAATG -> ACCACAAATGG
ACCACAAATGG -> CCACAAATGGA
CCACAAATGGA -> CACAAATGGAT
CACAAATGGAT -> ACAAATGGATT
ACAAATGGATT -> CAAATGGATTA
CAAATGGATTA -> AAATGGATTAC
AAATGGATTAC -> AATGGATTACG
AATGGATTACG -> ATGGATTACGA
ATGGATTACGA -> TGGATTACGAG
TGGATTACGAG -> GGATTACGAGA
GGATTACGAGA -> GATTACGAGAA
GATTACGAGAA -> ATTACGAGAAA
ATTACGAGAAA -> TTACGAGAAAC
TTACGAGAAAC -> TACGAGAAACA
TACGAGAAACA -> ACGAGAAACAT
ACGAGAAACAT -> CGAGAAACATA
CGAGAAACATA -> GAGAAACATAC
GAGAAACATAC -> AGAAACATACT
AGAAACATACT -> GAAACATACTA
GAAACATACTA -> AAACATACTAC
AAACATACTAC -> AACATACTACG
AACATACTACG -> ACATACTACGC
ACATACTACGC -> CATACTACGCC
CATACTACGCC -> ATACTACGCCG
ATACTACGCCG -> TACTACGCCGG
TACTACGCCGG -> ACTACGCCGGA
ACTACGCCGGA -> CTACGCCGGAT
CTACGCCGGAT -> TACGCCGGATG
TACGCCGGATG -> ACGCCGGATGA
ACGCCGGATGA -> CGCCGGATGAC
CGCCGGATGAC -> GCCGGATGACC
GCCGGATGACC -> CCGGATGACCC
CCGGATGACCC -> CGGATGACCCA
CGGATGACCCA -> GGATGACCCAC
GGATGACCCAC -> GATGACCCACC
GATGACCCACC -> ATGACCCACCC
ATGACCCACCC -> TGACCCACCCA
TGACCCACCCA -> GACCCACCCAC
GACCCACCCAC -> ACCCACCCACT
ACCCACCCACT -> CCCACCCACTA
CCCACCCACTA -> CCACCCACTAG
CCACCCACTAG -> CACCCACTAGT
CACCCACTAGT -> ACCCACTAGTG
ACCCACTAGTG -> CCCACTAGTGA
CCCACTAGTGA -> CCACTAGTGAG
CCACTAGTGAG -> CACTAGTGAGT
CACTAGTGAGT -> ACTAGTGAGTT
ACTAGTGAGTT -> CTAGTGAGTTA
CTAGTGAGTTA -> TAGTGAGTTAG
TAGTGAGTTAG -> AGTGAGTTAGG
AGTGAGTTAGG -> GTGAGTTAGGT
GTGAGTTAGGT -> TGAGTTAGGTA
TGAGTTAGGTA -> GAGTTAGGTAG
GAGTTAGGTAG -> AGTTAGGTAGA
AGTTAGGTAGA -> GTTAGGTAGAG
GTTAGGTAGAG -> TTAGGTAGAGA
TTAGGTAGAGA -> TAGGTAGAGAT
TAGGTAGAGAT -> AGGTAGAGATG
AGGTAGAGATG -> GGTAGAGATGG
GGTAGAGATGG -> GTAGAGATGGA
GTAGAGATGGA -> TAGAGATGGAA
TAGAGATGGAA -> AGAGATGGAAC
AGAGATGGAAC -> GAGATGGAACT
GAGATGGAACT -> AGATGGAACTG
AGATGGAACTG -> GATGGAACTGC
GATGGAACTGC -> ATGGAACTGCA
ATGGAACTGCA -> TGGAACTGCAT
TGGAACTGCAT -> GGAACTGCATG
GGAACTGCATG -> GAACTGCATGA
GAACTGCATGA -> AACTGCATGAG
AACTGCATGAG -> ACTGCATGAGT
ACTGCATGAGT -> CTGCATGAGTT
CTGCATGAGTT -> TGCATGAGTTC
TGCATGAGTTC -> GCATGAGTTCG
GCATGAGTTCG -> CATGAGTTCGT
CATGAGTTCGT -> ATGAGTTCGTA
ATGAGTTCGTA -> TGAGTTCGTAG
TGAGTTCGTAG -> GAGTTCGTAGT
GAGTTCGTAGT -> AGTTCGTAGTA
AGTTCGTAGTA -> GTTCGTAGTAT
GTTCGTAGTAT -> TTCGTAGTATG
TTCGTAGTATG -> TCGTAGTATGC
TCGTAGTATGC -> CGTAGTATGCT
CGTAGTATGCT -> GTAGTATGCTC
GTAGTATGCTC -> TAGTATGCTCC
TAGTATGCTCC -> AGTATGCTCCC
AGTATGCTCCC -> GTATGCTCCCT
GTATGCTCCCT -> TATGCTCCCTA
TATGCTCCCTA -> ATGCTCCCTAA
ATGCTCCCTAA -> TGCTCCCTAAG
TGCTCCCTAAG -> GCTCCCTAAGG
GCTCCCTAAGG -> CTCCCTAAGGC
CTCCCTAAGGC -> TCCCTAAGGCC
TCCCTAAGGCC -> CCCTAAGGCCG
CCCTAAGGCCG -> CCTAAGGCCGG
CCTAAGGCCGG -> CTAAGGCCGGC
CTAAGGCCGGC -> TAAGGCCGGCC
TAAGGCCGGCC -> AAGGCCGGCCA
AAGGCCGGCCA -> AGGCCGGCCAT
AGGCCGGCCAT -> GGCCGGCCATG
GGCCGGCCATG -> GCCGGCCATGC
GCCGGCCATGC -> CCGGCCATGCG
CCGGCCATGCG -> CGGCCATGCGG
CGGCCATGCGG -> GGCCATGCGGT
GGCCATGCGGT -> GCCATGCGGTC
GCCATGCGGTC -> CCATGCGGTCT
CCATGCGGTCT -> CATGCGGTCTG
CATGCGGTCTG -> ATGCGGTCTGC
ATGCGGTCTGC -> TGCGGTCTGCG
TGCGGTCTGCG -> GCGGTCTGCGA
GCGGTCTGCGA -> CGGTCTGCGAC
CGGTCTGCGAC -> GGTCTGCGACA
GGTCTGCGACA -> GTCTGCGACAA
GTCTGCGACAA -> TCTGCGACAAG
TCTGCGACAAG -> CTGCGACAAGA
CTGCGACAAGA -> TGCGACAAGAG
TGCGACAAGAG -> GCGACAAGAGG
GCGACAAGAGG -> CGACAAGAGGG
CGACAAGAGGG -> GACAAGAGGGA
GACAAGAGGGA -> ACAAGAGGGAT
ACAAGAGGGAT -> CAAGAGGGATC
CAAGAGGGATC -> AAGAGGGATCC
AAGAGGGATCC -> AGAGGGATCCT
AGAGGGATCCT -> GAGGGATCCTA
GAGGGATCCTA -> AGGGATCCTAG
AGGGATCCTAG -> GGGATCCTAGC
GGGATCCTAGC -> GGATCCTAGCC
GGATCCTAGCC -> GATCCTAGCCC
GATCCTAGCCC -> ATCCTAGCCCC
ATCCTAGCCCC -> TCCTAGCCCCG
TCCTAGCCCCG -> CCTAGCCCCGC
CCTAGCCCCGC -> CTAGCCCCGCC
CTAGCCCCGCC -> TAGCCCCGCCA
TAGCCCCGCCA -> AGCCCCGCCAT
AGCCCCGCCAT -> GCCCCGCCATT
GCCCCGCCATT -> CCCCGCCATTA
CCCCGCCATTA -> CCCGCCATTAT
CCCGCCATTAT -> CCGCCATTATT
CCGCCATTATT -> CGCCATTATTT
CGCCATTATTT -> GCCATTATTTT
GCCATTATTTT -> CCATTATTTTC
CCATTATTTTC -> CATTATTTTCG
CATTATTTTCG -> ATTATTTTCGT
ATTATTTTCGT -> TTATTTTCGTA
TTATTTTCGTA -> TATTTTCGTAC
TATTTTCGTAC -> ATTTTCGTACG
ATTTTCGTACG -> TTTTCGTACGA
TTTTCGTACGA -> TTTCGTACGAG
TTTCGTACGAG -> TTCGTACGAGT
TTCGTACGAGT -> TCGTACGAGTG
TCGTACGAGTG -> CGTACGAGTGC
CGTACGAGTGC -> GTACGAGTGCC
GTACGAGTGCC -> TACGAGTGCCT
TACGAGTGCCT -> ACGAGTGCCTC
ACGAGTGCCTC -> CGAGTGCCTCT
CGAGTGCCTCT -> GAGTGCCTCTC
GAGTGCCTCTC -> AGTGCCTCTCC
AGTGCCTCTCC -> GTGCCTCTCCG
GTGCCTCTCCG -> TGCCTCTCCGC
TGCCTCTCCGC -> GCCTCTCCGCT
GCCTCTCCGCT -> CCTCTCCGCTC
CCTCTCCGCTC -> CTCTCCGCTCG
CTCTCCGCTCG -> TCTCCGCTCGC
TCTCCGCTCGC -> CTCCGCTCGCA
CTCCGCTCGCA -> TCCGCTCGCAT
TCCGCTCGCAT -> CCGCTCGCATA
CCGCTCGCATA -> CGCTCGCATAC
CGCTCGCATAC -> GCTCGCATACG
GCTCGCATACG -> CTCGCATACGC
CTCGCATACGC -> TCGCATACGCA
TCGCATACGCA -> CGCATACGCAT
CGCATACGCAT -> GCATACGCATA
GCATACGCATA -> CATACGCATAA
CATACGCATAA -> ATACGCATAAT
ATACGCATAAT -> TACGCATAATC
TACGCATAATC -> ACGCATAATCC
ACGCATAATCC -> CGCATAATCCG
CGCATAATCCG -> GCATAATCCGA
GCATAATCCGA -> CATAATCCGAC
CATAATCCGAC -> ATAATCCGACT
ATAATCCGACT -> TAATCCGACTA
TAATCCGACTA -> AATCCGACTAT
AATCCGACTAT -> ATCCGACTATT
ATCCGACTATT -> TCCGACTATTC
TCCGACTATTC -> CCGACTATTCT
CCGACTATTCT -> CGACTATTCTC
CGACTATTCTC -> GACTATTCTCA
GACTATTCTCA -> ACTATTCTCAA
ACTATTCTCAA -> CTATTCTCAAA
CTATTCTCAAA -> TATTCTCAAAC
TATTCTCAAAC -> ATTCTCAAACT
ATTCTCAAACT -> TTCTCAAACTT
TTCTCAAACTT -> TCTCAAACTTC
TCTCAAACTTC -> CTCAAACTTCA
CTCAAACTTCA -> TCAAACTTCAA
TCAAACTTCAA -> CAAACTTCAAG
CAAACTTCAAG -> AAACTTCAAGA
AAACTTCAAGA -> AACTTCAAGAT
AACTTCAAGAT -> ACTTCAAGATA
ACTTCAAGATA -> CTTCAAGATAT
CTTCAAGATAT -> TTCAAGATATC
TTCAAGATATC -> TCAAGATATCG
TCAAGATATCG -> CAAGATATCGG
CAAGATATCGG -> AAGATATCGGA
AAGATATCGGA -> AGATATCGGAG
AGATATCGGAG -> GATATCGGAGA
GATATCGGAGA -> ATATCGGAGAC
ATATCGGAGAC -> TATCGGAGACG
TATCGGAGACG -> ATCGGAGACGA
ATCGGAGACGA -> TCGGAGACGAC
TCGGAGACGAC -> CGGAGACGACT
CGGAGACGACT -> GGAGACGACTC
GGAGACGACTC -> GAGACGACTCT
GAGACGACTCT -> AGACGACTCTT
AGACGACTCTT -> GACGACTCTTG
GACGACTCTTG -> ACGACTCTTGG
ACGACTCTTGG -> CGACTCTTGGG
CGACTCTTGGG -> GACTCTTGGGC
GACTCTTGGGC -> ACTCTTGGGCT
ACTCTTGGGCT -> CTCTTGGGCTC
CTCTTGGGCTC -> TCTTGGGCTCC
TCTTGGGCTCC -> CTTGGGCTCCA
CTTGGGCTCCA -> TTGGGCTCCAA
TTGGGCTCCAA -> TGGGCTCCAAG
TGGGCTCCAAG -> GGGCTCCAAGT
GGGCTCCAAGT -> GGCTCCAAGTT
GGCTCCAAGTT -> GCTCCAAGTTA
GCTCCAAGTTA -> CTCCAAGTTAT
CTCCAAGTTAT -> TCCAAGTTATT
TCCAAGTTATT -> CCAAGTTATTA
CCAAGTTATTA -> CAAGTTATTAA
CAAGTTATTAA -> AAGTTATTAAA
AAGTTATTAAA -> AGTTATTAAAA
AGTTATTAAAA -> GTTATTAAAAT
GTTATTAAAAT -> TTATTAAAATA
TTATTAAAATA -> TATTAAAATAC
TATTAAAATAC -> ATTAAAATACA
ATTAAAATACA -> TTAAAATACAA
TTAAAATACAA -> TAAAATACAAT
TAAAATACAAT -> AAAATACAATC
AAAATACAATC -> AAATACAATCT
AAATACAATCT -> AATACAATCTA
AATACAATCTA -> ATACAATCTAG
ATACAATCTAG -> TACAATCTAGT
TACAATCTAGT -> ACAATCTAGTT
ACAATCTAGTT -> CAATCTAGTTA
CAATCTAGTTA -> AATCTAGTTAT
AATCTAGTTAT -> ATCTAGTTATA
ATCTAGTTATA -> TCTAGTTATAC
TCTAGTTATAC -> CTAGTTATACG
CTAGTTATACG -> TAGTTATACGT
TAGTTATACGT -> AGTTATACGTA
AGTTATACGTA -> GTTATACGTAG
GTTATACGTAG -> TTATACGTAGG
TTATACGTAGG -> TATACGTAGGC
TATACGTAGGC -> ATACGTAGGCC
ATACGTAGGCC -> TACGTAGGCCT
TACGTAGGCCT -> ACGTAGGCCTT
ACGTAGGCCTT -> CGTAGGCCTTC
CGTAGGCCTTC -> GTAGGCCTTCA
GTAGGCCTTCA -> TAGGCCTTCAA
TAGGCCTTCAA -> AGGCCTTCAAA
AGGCCTTCAAA -> GGCCTTCAAAC
GGCCTTCAAAC -> GCCTTCAAACC
GCCTTCAAACC -> CCTTCAAACCC
CCTTCAAACCC -> CTTCAAACCCA
CTTCAAACCCA -> TTCAAACCCAC
TTCAAACCCAC -> TCAAACCCACC
TCAAACCCACC -> CAAACCCACCA
CAAACCCACCA -> AAACCCACCAG
AAACCCACCAG -> AACCCACCAGC
AACCCACCAGC -> ACCCACCAGCG
ACCCACCAGCG -> CCCACCAGCGG
CCCACCAGCGG -> CCACCAGCGGG
CCACCAGCGGG -> CACCAGCGGGC
CACCAGCGGGC -> ACCAGCGGGCA
ACCAGCGGGCA -> CCAGCGGGCAG,CCAGCGGGCAT
CCAGCGGGCAG -> CAGCGGGCAGC
CAGCGGGCAGC -> AGCGGGCAGCA
AGCGGGCAGCA -> GCGGGCAGCAT
GCGGGCAGCAT -> CGGGCAGCATA
CGGGCAGCATA -> GGGCAGCATAC
GGGCAGCATAC -> GGCAGCATACT
GGCAGCATACT -> GCAGCATACTG
GCAGCATACTG -> CAGCATACTGC
CAGCATACTGC -> AGCATACTGCT
AGCATACTGCT -> GCATACTGCTG
GCATACTGCTG -> CATACTGCTGA
CATACTGCTGA -> ATACTGCTGAC
ATACTGCTGAC -> TACTGCTGACA
TACTGCTGACA -> ACTGCTGACAT
ACTGCTGACAT -> CTGCTGACATA
CTGCTGACATA -> TGCTGACATAT
TGCTGACATAT -> GCTGACATATG
GCTGACATATG -> CTGACATATGC
CTGACATATGC -> TGACATATGCG
TGACATATGCG -> GACATATGCGC
GACATATGCGC -> ACATATGCGCC
ACATATGCGCC -> CATATGCGCCG
CATATGCGCCG -> ATATGCGCCGT
ATATGCGCCGT -> TATGCGCCGTA
TATGCGCCGTA -> ATGCGCCGTAC
ATGCGCCGTAC -> TGCGCCGTACG
TGCGCCGTACG -> GCGCCGTACGC
GCGCCGTACGC -> CGCCGTACGCA
CGCCGTACGCA -> GCCGTACGCAG
GCCGTACGCAG -> CCGTACGCAGG
CCGTACGCAGG -> CGTACGCAGGC
CGTACGCAGGC -> GTACGCAGGCG
GTACGCAGGCG -> TACGCAGGCGT
TACGCAGGCGT -> ACGCAGGCGTA
ACGCAGGCGTA -> CGCAGGCGTAT
CGCAGGCGTAT -> GCAGGCGTATG
GCAGGCGTATG -> CAGGCGTATGG
CAGGCGTATGG -> AGGCGTATGGT
AGGCGTATGGT -> GGCGTATGGTC
GGCGTATGGTC -> GCGTATGGTCC
GCGTATGGTCC -> CGTATGGTCCA
CGTATGGTCCA -> GTATGGTCCAT
GTATGGTCCAT -> TATGGTCCATG
TATGGTCCATG -> ATGGTCCATGC
ATGGTCCATGC -> TGGTCCATGCG
TGGTCCATGCG -> GGTCCATGCGC
GGTCCATGCGC -> GTCCATGCGCC
GTCCATGCGCC -> TCCATGCGCCG
TCCATGCGCCG -> CCATGCGCCGG
CCATGCGCCGG -> CATGCGCCGGA
CATGCGCCGGA -> ATGCGCCGGAT
ATGCGCCGGAT -> TGCGCCGGATA
TGCGCCGGATA -> GCGCCGGATAC
GCGCCGGATAC -> CGCCGGATACC
CGCCGGATACC -> GCCGGATACCT
GCCGGATACCT -> CCGGATACCTC
CCGGATACCTC -> CGGATACCTCC
CGGATACCTCC -> GGATACCTCCT
GGATACCTCCT -> GATACCTCCTT
GATACCTCCTT -> ATACCTCCTTC
ATACCTCCTTC -> TACCTCCTTCC
TACCTCCTTCC -> ACCTCCTTCCA
ACCTCCTTCCA -> CCTCCTTCCAA
CCTCCTTCCAA -> CTCCTTCCAAT
CTCCTTCCAAT -> TCCTTCCAATT
TCCTTCCAATT -> CCTTCCAATTT
CCTTCCAATTT -> CTTCCAATTTC
CTTCCAATTTC -> TTCCAATTTCT
TTCCAATTTCT -> TCCAATTTCTA
TCCAATTTCTA -> CCAATTTCTAT
CCAATTTCTAT -> CAATTTCTATA
CAATTTCTATA -> AATTTCTATAG
AATTTCTATAG -> ATTTCTATAGT
ATTTCTATAGT -> TTTCTATAGTG
TTTCTATAGTG -> TTCTATAGTGG
TTCTATAGTGG -> TCTATAGTGGT
TCTATAGTGGT -> CTATAGTGGTC
CTATAGTGGTC -> TATAGTGGTCG
TATAGTGGTCG -> ATAGTGGTCGC
ATAGTGGTCGC -> TAGTGGTCGCG
TAGTGGTCGCG -> AGTGGTCGCGA
AGTGGTCGCGA -> GTGGTCGCGAG
GTGGTCGCGAG -> TGGTCGCGAGA
TGGTCGCGAGA -> GGTCGCGAGAC
GGTCGCGAGAC -> GTCGCGAGACA
GTCGCGAGACA -> TCGCGAGACAA
TCGCGAGACAA -> CGCGAGACAAC
CGCGAGACAAC -> GCGAGACAACG
GCGAGACAACG -> CGAGACAACGC
CGAGACAACGC -> GAGACAACGCG
GAGACAACGCG -> AGACAACGCGA
AGACAACGCGA -> GACAACGCGAC
GACAACGCGAC -> ACAACGCGACG
ACAACGCGACG -> CAACGCGACGC
CAACGCGACGC -> AACGCGACGCG
AACGCGACGCG -> ACGCGACGCGA
ACGCGACGCGA -> CGCGACGCGAA
CGCGACGCGAA -> GCGACGCGAAG
GCGACGCGAAG -> CGACGCGAAGA
CGACGCGAAGA -> GACGCGAAGAA
GACGCGAAGAA -> ACGCGAAGAAG
ACGCGAAGAAG -> CGCGAAGAAGC
CGCGAAGAAGC -> GCGAAGAAGCC
GCGAAGAAGCC -> CGAAGAAGCCT
CGAAGAAGCCT -> GAAGAAGCCTT
GAAGAAGCCTT -> AAGAAGCCTTT
AAGAAGCCTTT -> AGAAGCCTTTT
AGAAGCCTTTT -> GAAGCCTTTTC
GAAGCCTTTTC -> AAGCCTTTTCT
AAGCCTTTTCT -> AGCCTTTTCTT
AGCCTTTTCTT -> GCCTTTTCTTG
GCCTTTTCTTG -> CCTTTTCTTGA
CCTTTTCTTGA -> CTTTTCTTGAT
CTTTTCTTGAT -> TTTTCTTGATA
TTTTCTTGATA -> TTTCTTGATAA
TTTCTTGATAA -> TTCTTGATAAT
TTCTTGATAAT -> TCTTGATAATT
TCTTGATAATT -> CTTGATAATTT
CTTGATAATTT -> TTGATAATTTG
TTGATAATTTG -> TGATAATTTGG
TGATAATTTGG -> GATAATTTGGT
GATAATTTGGT -> ATAATTTGGTC
ATAATTTGGTC -> TAATTTGGTCA
TAATTTGGTCA -> AATTTGGTCAT
AATTTGGTCAT -> ATTTGGTCATA
ATTTGGTCATA -> TTTGGTCATAC
TTTGGTCATAC -> TTGGTCATACA
TTGGTCATACA -> TGGTCATACAT
TGGTCATACAT -> GGTCATACATA
GGTCATACATA -> GTCATACATAG
GTCATACATAG -> TCATACATAGC
TCATACATAGC -> CATACATAGCC
CATACATAGCC -> ATACATAGCCT
ATACATAGCCT -> TACATAGCCTA
TACATAGCCTA -> ACATAGCCTAC
ACATAGCCTAC -> CATAGCCTACG
CATAGCCTACG -> ATAGCCTACGC
ATAGCCTACGC -> TAGCCTACGCC
TAGCCTACGCC -> AGCCTACGCCA
AGCCTACGCCA -> GCCTACGCCAT
GCCTACGCCAT -> CCTACGCCATC
CCTACGCCATC -> CTACGCCATCT
CTACGCCATCT -> TACGCCATCTC
TACGCCATCTC -> ACGCCATCTCG
ACGCCATCTCG -> CGCCATCTCGG
CGCCATCTCGG -> GCCATCTCGGA
GCCATCTCGGA -> CCATCTCGGAT
CCATCTCGGAT -> CATCTCGGATG
CATCTCGGATG -> ATCTCGGATGT
ATCTCGGATGT -> TCTCGGATGTC
TCTCGGATGTC -> CTCGGATGTCG
CTCGGATGTCG -> TCGGATGTCGT
TCGGATGTCGT -> CGGATGTCGTC
CGGATGTCGTC -> GGATGTCGTCC
GGATGTCGTCC -> GATGTCGTCCC
GATGTCGTCCC -> ATGTCGTCCCC
ATGTCGTCCCC -> TGTCGTCCCCA
TGTCGTCCCCA -> GTCGTCCCCAA
GTCGTCCCCAA -> TCGTCCCCAAG
TCGTCCCCAAG -> CGTCCCCAAGT
CGTCCCCAAGT -> GTCCCCAAGTT
GTCCCCAAGTT -> TCCCCAAGTTT
TCCCCAAGTTT -> CCCCAAGTTTA
CCCCAAGTTTA -> CCCAAGTTTAA
CCCAAGTTTAA -> CCAAGTTTAAT
CCAAGTTTAAT -> CAAGTTTAATG
CAAGTTTAATG -> AAGTTTAATGG
AAGTTTAATGG -> AGTTTAATGGT
AGTTTAATGGT -> GTTTAATGGTC
GTTTAATGGTC -> TTTAATGGTCG
TTTAATGGTCG -> TTAATGGTCGG
TTAATGGTCGG -> TAATGGTCGGG
TAATGGTCGGG -> AATGGTCGGGT
AATGGTCGGGT -> ATGGTCGGGTT
ATGGTCGGGTT -> TGGTCGGGTTT
TGGTCGGGTTT -> GGTCGGGTTTA
GGTCGGGTTTA -> GTCGGGTTTAG
GTCGGGTTTAG -> TCGGGTTTAGT
TCGGGTTTAGT -> CGGGTTTAGTT
CGGGTTTAGTT -> GGGTTTAGTTC
GGGTTTAGTTC -> GGTTTAGTTCG
GGTTTAGTTCG -> GTTTAGTTCGC
GTTTAGTTCGC -> TTTAGTTCGCA
TTTAGTTCGCA -> TTAGTTCGCAT
TTAGTTCGCAT -> TAGTTCGCATT
TAGTTCGCATT -> AGTTCGCATTA
AGTTCGCATTA -> GTTCGCATTAA
GTTCGCATTAA -> TTCGCATTAAA
TTCGCATTAAA -> TCGCATTAAAG
TCGCATTAAAG -> CGCATTAAAGA
CGCATTAAAGA -> GCATTAAAGAG
GCATTAAAGAG -> CATTAAAGAGC
CATTAAAGAGC -> ATTAAAGAGCA
ATTAAAGAGCA -> TTAAAGAGCAC
TTAAAGAGCAC -> TAAAGAGCACT
TAAAGAGCACT -> AAAGAGCACTT
AAAGAGCACTT -> AAGAGCACTTG
AAGAGCACTTG -> AGAGCACTTGC
AGAGCACTTGC -> GAGCACTTGCG
GAGCACTTGCG -> AGCACTTGCGC
AGCACTTGCGC -> GCACTTGCGCC
GCACTTGCGCC -> CACTTGCGCCG
CACTTGCGCCG -> ACTTGCGCCGC
ACTTGCGCCGC -> CTTGCGCCGCG
CTTGCGCCGCG -> TTGCGCCGCGC
TTGCGCCGCGC -> TGCGCCGCGCC
TGCGCCGCGCC -> GCGCCGCGCCA
GCGCCGCGCCA -> CGCCGCGCCAT
CGCCGCGCCAT -> GCCGCGCCATC
GCCGCGCCATC -> CCGCGCCATCG
CCGCGCCATCG -> CGCGCCATCGG
CGCGCCATCGG -> GCGCCATCGGA
GCGCCATCGGA -> CGCCATCGGAA
CGCCATCGGAA -> GCCATCGGAAA
GCCATCGGAAA -> CCATCGGAAAC
CCATCGGAAAC -> CATCGGAAACC
CATCGGAAACC -> ATCGGAAACCA
ATCGGAAACCA -> TCGGAAACCAT
TCGGAAACCAT -> CGGAAACCATC
CGGAAACCATC -> GGAAACCATCG
GGAAACCATCG -> GAAACCATCGC
GAAACCATCGC -> AAACCATCGCG
AAACCATCGCG -> AACCATCGCGA
AACCATCGCGA -> ACCATCGCGAT
ACCATCGCGAT -> CCATCGCGATG
CCATCGCGATG -> CATCGCGATGA
CATCGCGATGA -> ATCGCGATGAC
ATCGCGATGAC -> TCGCGATGACG
TCGCGATGACG -> CGCGATGACGT
CGCGATGACGT -> GCGATGACGTG
GCGATGACGTG -> CGATGACGTGC
CGATGACGTGC -> GATGACGTGCG
GATGACGTGCG -> ATGACGTGCGC
ATGACGTGCGC -> TGACGTGCGCT
TGACGTGCGCT -> GACGTGCGCTT
GACGTGCGCTT -> ACGTGCGCTTT
ACGTGCGCTTT -> CGTGCGCTTTC
CGTGCGCTTTC -> GTGCGCTTTCG
GTGCGCTTTCG -> TGCGCTTTCGC
TGCGCTTTCGC -> GCGCTTTCGCA
GCGCTTTCGCA -> CGCTTTCGCAC
CGCTTTCGCAC -> GCTTTCGCACC
GCTTTCGCACC -> CTTTCGCACCT
CTTTCGCACCT -> TTTCGCACCTT
TTTCGCACCTT -> TTCGCACCTTT
TTCGCACCTTT -> TCGCACCTTTA
TCGCACCTTTA -> CGCACCTTTAA
CGCACCTTTAA -> GCACCTTTAAG
GCACCTTTAAG -> CACCTTTAAGA
CACCTTTAAGA -> ACCTTTAAGAA
ACCTTTAAGAA -> CCTTTAAGAAC
CCTTTAAGAAC -> CTTTAAGAACG
CTTTAAGAACG -> TTTAAGAACGA
TTTAAGAACGA -> TTAAGAACGAG
TTAAGAACGAG -> TAAGAACGAGA
TAAGAACGAGA -> AAGAACGAGAC
AAGAACGAGAC -> AGAACGAGACA
AGAACGAGACA -> GAACGAGACAC
GAACGAGACAC -> AACGAGACACA
AACGAGACACA -> ACGAGACACAT
ACGAGACACAT -> CGAGACACATT
CGAGACACATT -> GAGACACATTG
GAGACACATTG -> AGACACATTGC
AGACACATTGC -> GACACATTGCA
GACACATTGCA -> ACACATTGCAT
ACACATTGCAT -> CACATTGCATT
CACATTGCATT -> ACATTGCATTC
ACATTGCATTC -> CATTGCATTCG
CATTGCATTCG -> ATTGCATTCGT
ATTGCATTCGT -> TTGCATTCGTA
TTGCATTCGTA -> TGCATTCGTAC
TGCATTCGTAC -> GCATTCGTACC
GCATTCGTACC -> CATTCGTACCA
CATTCGTACCA -> ATTCGTACCAA
ATTCGTACCAA -> TTCGTACCAAT
TTCGTACCAAT -> TCGTACCAATT
TCGTACCAATT -> CGTACCAATTG
CGTACCAATTG -> GTACCAATTGA
GTACCAATTGA -> TACCAATTGAG
TACCAATTGAG -> ACCAATTGAGA
ACCAATTGAGA -> CCAATTGAGAA
CCAATTGAGAA -> CAATTGAGAAC
CAATTGAGAAC -> AATTGAGAACA
AATTGAGAACA -> ATTGAGAACAT
ATTGAGAACAT -> TTGAGAACATT
TTGAGAACATT -> TGAGAACATTC
TGAGAACATTC -> GAGAACATTCA
GAGAACATTCA -> AGAACATTCAA
AGAACATTCAA -> GAACATTCAAC
GAACATTCAAC -> AACATTCAACT
AACATTCAACT -> ACATTCAACTA
ACATTCAACTA -> CATTCAACTAC
CATTCAACTAC -> ATTCAACTACG
ATTCAACTACG -> TTCAACTACGT
TTCAACTACGT -> TCAACTACGTT
TCAACTACGTT -> CAACTACGTTA
CAACTACGTTA -> AACTACGTTAC
AACTACGTTAC -> ACTACGTTACT
ACTACGTTACT -> CTACGTTACTC
CTACGTTACTC -> TACGTTACTCG
TACGTTACTCG -> ACGTTACTCGC
ACGTTACTCGC -> CGTTACTCGCG
CGTTACTCGCG -> GTTACTCGCGA
GTTACTCGCGA -> TTACTCGCGAC
TTACTCGCGAC -> TACTCGCGACC
TACTCGCGACC -> ACTCGCGACCG
ACTCGCGACCG -> CTCGCGACCGG
CTCGCGACCGG -> TCGCGACCGGG
TCGCGACCGGG -> CGCGACCGGGT
CGCGACCGGGT -> GCGACCGGGTC
GCGACCGGGTC -> CGACCGGGTCA
CGACCGGGTCA -> GACCGGGTCAT
GACCGGGTCAT -> ACCGGGTCATG
ACCGGGTCATG -> CCGGGTCATGG
CCGGGTCATGG -> CGGGTCATGGC
CGGGTCATGGC -> GGGTCATGGCG
GGGTCATGGCG -> GGTCATGGCGC
GGTCATGGCGC -> GTCATGGCGCT
GTCATGGCGCT -> TCATGGCGCTC
TCATGGCGCTC -> CATGGCGCTCG
CATGGCGCTCG -> ATGGCGCTCGG
ATGGCGCTCGG -> TGGCGCTCGGG
TGGCGCTCGGG -> GGCGCTCGGGT
GGCGCTCGGGT -> GCGCTCGGGTC
GCGCTCGGGTC -> CGCTCGGGTCG
CGCTCGGGTCG -> GCTCGGGTCGT
GCTCGGGTCGT -> CTCGGGTCGTT
CTCGGGTCGTT -> TCGGGTCGTTA
TCGGGTCGTTA -> CGGGTCGTTAG
CGGGTCGTTAG -> GGGTCGTTAGG
GGGTCGTTAGG -> GGTCGTTAGGA
GGTCGTTAGGA -> GTCGTTAGGAA
GTCGTTAGGAA -> TCGTTAGGAAG
TCGTTAGGAAG -> CGTTAGGAAGA
CGTTAGGAAGA -> GTTAGGAAGAA
GTTAGGAAGAA -> TTAGGAAGAAA
TTAGGAAGAAA -> TAGGAAGAAAC
TAGGAAGAAAC -> AGGAAGAAACA
AGGAAGAAACA -> GGAAGAAACAG
GGAAGAAACAG -> GAAGAAACAGG
GAAGAAACAGG -> AAGAAACAGGA
AAGAAACAGGA -> AGAAACAGGAT
AGAAACAGGAT -> GAAACAGGATG
GAAACAGGATG -> AAACAGGATGG
AAACAGGATGG -> AACAGGATGGC
AACAGGATGGC -> ACAGGATGGCC
ACAGGATGGCC -> CAGGATGGCCT
CAGGATGGCCT -> AGGATGGCCTC
AGGATGGCCTC -> GGATGGCCTCG
GGATGGCCTCG -> GATGGCCTCGA
GATGGCCTCGA -> ATGGCCTCGAT
ATGGCCTCGAT -> TGGCCTCGATG
TGGCCTCGATG -> GGCCTCGATGA
GGCCTCGATGA -> GCCTCGATGAG
GCCTCGATGAG -> CCTCGATGAGC
CCTCGATGAGC -> CTCGATGAGCC
CTCGATGAGCC -> TCGATGAGCCT
TCGATGAGCCT -> CGATGAGCCTG
CGATGAGCCTG -> GATGAGCCTGG
GATGAGCCTGG -> ATGAGCCTGGT
ATGAGCCTGGT -> TGAGCCTGGTC
TGAGCCTGGTC -> GAGCCTGGTCG
GAGCCTGGTCG -> AGCCTGGTCGA
AGCCTGGTCGA -> GCCTGGTCGAT
GCCTGGTCGAT -> CCTGGTCGATG
CCTGGTCGATG -> CTGGTCGATGA
CTGGTCGATGA -> TGGTCGATGAC
TGGTCGATGAC -> GGTCGATGACC
GGTCGATGACC -> GTCGATGACCG
GTCGATGACCG -> TCGATGACCGC
TCGATGACCGC -> CGATGACCGCC
CGATGACCGCC -> GATGACCGCCA
GATGACCGCCA -> ATGACCGCCAC
ATGACCGCCAC -> TGACCGCCACA
TGACCGCCACA -> GACCGCCACAG
GACCGCCACAG -> ACCGCCACAGA
ACCGCCACAGA -> CCGCCACAGAT
CCGCCACAGAT -> CGCCACAGATA
CGCCACAGATA -> GCCACAGATAA
GCCACAGATAA -> CCACAGATAAT
CCACAGATAAT -> CACAGATAATC
CACAGATAATC -> ACAGATAATCT
ACAGATAATCT -> CAGATAATCTG
CAGATAATCTG -> AGATAATCTGG
AGATAATCTGG -> GATAATCTGGA
GATAATCTGGA -> ATAATCTGGAA
ATAATCTGGAA -> TAATCTGGAAG
TAATCTGGAAG -> AATCTGGAAGC
AATCTGGAAGC -> ATCTGGAAGCG
ATCTGGAAGCG -> TCTGGAAGCGT
TCTGGAAGCGT -> CTGGAAGCGTG
CTGGAAGCGTG -> TGGAAGCGTGC
TGGAAGCGTGC -> GGAAGCGTGCT
GGAAGCGTGCT -> GAAGCGTGCTT
GAAGCGTGCTT -> AAGCGTGCTTA
AAGCGTGCTTA -> AGCGTGCTTAA
AGCGTGCTTAA -> GCGTGCTTAAC
GCGTGCTTAAC -> CGTGCTTAACG
CGTGCTTAACG -> GTGCTTAACGG
GTGCTTAACGG -> TGCTTAACGGC
TGCTTAACGGC -> GCTTAACGGCT
GCTTAACGGCT -> CTTAACGGCTT
CTTAACGGCTT -> TTAACGGCTTT
TTAACGGCTTT -> TAACGGCTTTG
TAACGGCTTTG -> AACGGCTTTGT
AACGGCTTTGT -> ACGGCTTTGTC
ACGGCTTTGTC -> CGGCTTTGTCA
CGGCTTTGTCA -> GGCTTTGTCAA
GGCTTTGTCAA -> GCTTTGTCAAA
GCTTTGTCAAA -> CTTTGTCAAAC
CTTTGTCAAAC -> TTTGTCAAACT
TTTGTCAAACT -> TTGTCAAACTC
TTGTCAAACTC -> TGTCAAACTCA
TGTCAAACTCA -> GTCAAACTCAC
GTCAAACTCAC -> TCAAACTCACT
TCAAACTCACT -> CAAACTCACTA
CAAACTCACTA -> AAACTCACTAA
AAACTCACTAA -> AACTCACTAAC
AACTCACTAAC -> ACTCACTAACG
ACTCACTAACG -> CTCACTAACGC
CTCACTAACGC -> TCACTAACGCG
TCACTAACGCG -> CACTAACGCGC
CACTAACGCGC -> ACTAACGCGCG
ACTAACGCGCG -> CTAACGCGCGA
CTAACGCGCGA -> TAACGCGCGAG
TAACGCGCGAG -> AACGCGCGAGC
AACGCGCGAGC -> ACGCGCGAGCC
ACGCGCGAGCC -> CGCGCGAGCCC
CGCGCGAGCCC -> GCGCGAGCCCG
GCGCGAGCCCG -> CGCGAGCCCGC
CGCGAGCCCGC -> GCGAGCCCGCG
GCGAGCCCGCG -> CGAGCCCGCGC
CGAGCCCGCGC -> GAGCCCGCGCG
GAGCCCGCGCG -> AGCCCGCGCGA
AGCCCGCGCGA -> GCCCGCGCGAG
GCCCGCGCGAG -> CCCGCGCGAGA
CCCGCGCGAGA -> CCGCGCGAGAT
CCGCGCGAGAT -> CGCGCGAGATG
CGCGCGAGATG -> GCGCGAGATGC
GCGCGAGATGC -> CGCGAGATGCT
CGCGAGATGCT -> GCGAGATGCTG
GCGAGATGCTG -> CGAGATGCTGA
CGAGATGCTGA -> GAGATGCTGAA
GAGATGCTGAA -> AGATGCTGAAC
AGATGCTGAAC -> GATGCTGAACG
GATGCTGAACG -> ATGCTGAACGT
ATGCTGAACGT -> TGCTGAACGTT
TGCTGAACGTT -> GCTGAACGTTC
GCTGAACGTTC -> CTGAACGTTCA
CTGAACGTTCA -> TGAACGTTCAC
TGAACGTTCAC -> GAACGTTCACT
GAACGTTCACT -> AACGTTCACTC
AACGTTCACTC -> ACGTTCACTCT
ACGTTCACTCT -> CGTTCACTCTT
CGTTCACTCTT -> GTTCACTCTTA
GTTCACTCTTA -> TTCACTCTTAG
TTCACTCTTAG -> TCACTCTTAGA
TCACTCTTAGA -> CACTCTTAGAG
CACTCTTAGAG -> ACTCTTAGAGA
ACTCTTAGAGA -> CTCTTAGAGAA
CTCTTAGAGAA -> TCTTAGAGAAT
TCTTAGAGAAT -> CTTAGAGAATA
CTTAGAGAATA -> TTAGAGAATAA
TTAGAGAATAA -> TAGAGAATAAA
TAGAGAATAAA -> AGAGAATAAAG
AGAGAATAAAG -> GAGAATAAAGA
GAGAATAAAGA -> AGAATAAAGAC
AGAATAAAGAC -> GAATAAAGACC
GAATAAAGACC -> AATAAAGACCC
AATAAAGACCC -> ATAAAGACCCC
ATAAAGACCCC -> TAAAGACCCCG
TAAAGACCCCG -> AAAGACCCCGA
AAAGACCCCGA -> AAGACCCCGAC
AAGACCCCGAC -> AGACCCCGACA
AGACCCCGACA -> GACCCCGACAG
GACCCCGACAG -> ACCCCGACAGA
ACCCCGACAGA -> CCCCGACAGAG
CCCCGACAGAG -> CCCGACAGAGG
CCCGACAGAGG -> CCGACAGAGGG
CCGACAGAGGG -> CGACAGAGGGG
CGACAGAGGGG -> GACAGAGGGGT
GACAGAGGGGT -> ACAGAGGGGTG
ACAGAGGGGTG -> CAGAGGGGTGT
CAGAGGGGTGT -> AGAGGGGTGTA
AGAGGGGTGTA -> GAGGGGTGTAT
GAGGGGTGTAT -> AGGGGTGTATA
AGGGGTGTATA -> GGGGTGTATAA
GGGGTGTATAA -> GGGTGTATAAT
GGGTGTATAAT -> GGTGTATAATT
GGTGTATAATT -> GTGTATAATTA
GTGTATAATTA -> TGTATAATTAG
TGTATAATTAG -> GTATAATTAGT
GTATAATTAGT -> TATAATTAGTA
TATAATTAGTA -> ATAATTAGTAC
ATAATTAGTAC -> TAATTAGTACT
TAATTAGTACT -> AATTAGTACTT
AATTAGTACTT -> ATTAGTACTTA
ATTAGTACTTA -> TTAGTACTTAG
TTAGTACTTAG -> TAGTACTTAGG
TAGTACTTAGG -> AGTACTTAGGC
AGTACTTAGGC -> GTACTTAGGCG
GTACTTAGGCG -> TACTTAGGCGG
TACTTAGGCGG -> ACTTAGGCGGT
ACTTAGGCGGT -> CTTAGGCGGTT
CTTAGGCGGTT -> TTAGGCGGTTA
TTAGGCGGTTA -> TAGGCGGTTAG
TAGGCGGTTAG -> AGGCGGTTAGA
AGGCGGTTAGA -> GGCGGTTAGAT
GGCGGTTAGAT -> GCGGTTAGATC
GCGGTTAGATC -> CGGTTAGATCC
CGGTTAGATCC -> GGTTAGATCCT
GGTTAGATCCT -> GTTAGATCCTT
GTTAGATCCTT -> TTAGATCCTTG
TTAGATCCTTG -> TAGATCCTTGT
TAGATCCTTGT -> AGATCCTTGTT
AGATCCTTGTT -> GATCCTTGTTA
GATCCTTGTTA -> ATCCTTGTTAA
ATCCTTGTTAA -> TCCTTGTTAAT
TCCTTGTTAAT -> CCTTGTTAATT
CCTTGTTAATT -> CTTGTTAATTC
CTTGTTAATTC -> TTGTTAATTCG
TTGTTAATTCG -> TGTTAATTCGC
TGTTAATTCGC -> GTTAATTCGCG
GTTAATTCGCG -> TTAATTCGCGG
TTAATTCGCGG -> TAATTCGCGGC
TAATTCGCGGC -> AATTCGCGGCG
AATTCGCGGCG -> ATTCGCGGCGA
ATTCGCGGCGA -> TTCGCGGCGAC
TTCGCGGCGAC -> TCGCGGCGACC
TCGCGGCGACC -> CGCGGCGACCC
CGCGGCGACCC -> GCGGCGACCCG
GCGGCGACCCG -> CGGCGACCCGG
CGGCGACCCGG -> GGCGACCCGGG
GGCGACCCGGG -> GCGACCCGGGA
GCGACCCGGGA -> CGACCCGGGAT
CGACCCGGGAT -> GACCCGGGATT
GACCCGGGATT -> ACCCGGGATTT
ACCCGGGATTT -> CCCGGGATTTA
CCCGGGATTTA -> CCGGGATTTAT
CCGGGATTTAT -> CGGGATTTATG
CGGGATTTATG -> GGGATTTATGC
GGGATTTATGC -> GGATTTATGCT
GGATTTATGCT -> GATTTATGCTG
GATTTATGCTG -> ATTTATGCTGC
ATTTATGCTGC -> TTTATGCTGCG
TTTATGCTGCG -> TTATGCTGCGA
TTATGCTGCGA -> TATGCTGCGAG
TATGCTGCGAG -> ATGCTGCGAGC
ATGCTGCGAGC -> TGCTGCGAGCC
TGCTGCGAGCC -> GCTGCGAGCCG
GCTGCGAGCCG -> CTGCGAGCCGG
CTGCGAGCCGG -> TGCGAGCCGGG
TGCGAGCCGGG -> GCGAGCCGGGG
GCGAGCCGGGG -> CGAGCCGGGGT
CGAGCCGGGGT -> GAGCCGGGGTC
GAGCCGGGGTC -> AGCCGGGGTCA
AGCCGGGGTCA -> GCCGGGGTCAC
GCCGGGGTCAC -> CCGGGGTCACT
CCGGGGTCACT -> CGGGGTCACTA
CGGGGTCACTA -> GGGGTCACTAC
GGGGTCACTAC -> GGGTCACTACA
GGGTCACTACA -> GGTCACTACAA
GGTCACTACAA -> GTCACTACAAG
GTCACTACAAG -> TCACTACAAGC
TCACTACAAGC -> CACTACAAGCG
CACTACAAGCG -> ACTACAAGCGC
ACTACAAGCGC -> CTACAAGCGCA
CTACAAGCGCA -> TACAAGCGCAA
TACAAGCGCAA -> ACAAGCGCAAG
ACAAGCGCAAG -> CAAGCGCAAGC
CAAGCGCAAGC -> AAGCGCAAGCA
AAGCGCAAGCA -> AGCGCAAGCAG
AGCGCAAGCAG -> GCGCAAGCAGG
GCGCAAGCAGG -> CGCAAGCAGGT
CGCAAGCAGGT -> GCAAGCAGGTC
GCAAGCAGGTC -> CAAGCAGGTCT
CAAGCAGGTCT -> AAGCAGGTCTA
AAGCAGGTCTA -> AGCAGGTCTAC
AGCAGGTCTAC -> GCAGGTCTACC
GCAGGTCTACC -> CAGGTCTACCC
CAGGTCTACCC -> AGGTCTACCCG
AGGTCTACCCG -> GGTCTACCCGC
GGTCTACCCGC -> GTCTACCCGCG
GTCTACCCGCG -> TCTACCCGCGG
TCTACCCGCGG -> CTACCCGCGGT
CTACCCGCGGT -> TACCCGCGGTT
TACCCGCGGTT -> ACCCGCGGTTG
ACCCGCGGTTG -> CCCGCGGTTGG
CCCGCGGTTGG -> CCGCGGTTGGA
CCGCGGTTGGA -> CGCGGTTGGAT
CGCGGTTGGAT -> GCGGTTGGATC
GCGGTTGGATC -> CGGTTGGATCG
CGGTTGGATCG -> GGTTGGATCGC
GGTTGGATCGC -> GTTGGATCGCG
GTTGGATCGCG -> TTGGATCGCGA
TTGGATCGCGA -> TGGATCGCGAA
TGGATCGCGAA -> GGATCGCGAAG
GGATCGCGAAG -> GATCGCGAAGG
GATCGCGAAGG -> ATCGCGAAGGT
ATCGCGAAGGT -> TCGCGAAGGTT
TCGCGAAGGTT -> CGCGAAGGTTA
CGCGAAGGTTA -> GCGAAGGTTAT
GCGAAGGTTAT -> CGAAGGTTATT
CGAAGGTTATT -> GAAGGTTATTA
GAAGGTTATTA -> AAGGTTATTAC
AAGGTTATTAC -> AGGTTATTACG
AGGTTATTACG -> GGTTATTACGT
GGTTATTACGT -> GTTATTACGTT
GTTATTACGTT -> TTATTACGTTG
TTATTACGTTG -> TATTACGTTGG
TATTACGTTGG -> ATTACGTTGGA
ATTACGTTGGA -> TTACGTTGGAG
TTACGTTGGAG -> TACGTTGGAGA
TACGTTGGAGA -> ACGTTGGAGAG
ACGTTGGAGAG -> CGTTGGAGAGT
CGTTGGAGAGT -> GTTGGAGAGTG
GTTGGAGAGTG -> TTGGAGAGTGG
TTGGAGAGTGG -> TGGAGAGTGGA
TGGAGAGTGGA -> GGAGAGTGGAA
GGAGAGTGGAA -> GAGAGTGGAAG
GAGAGTGGAAG -> AGAGTGGAAGT
AGAGTGGAAGT -> GAGTGGAAGTA
GAGTGGAAGTA -> AGTGGAAGTAG
AGTGGAAGTAG -> GTGGAAGTAGC
GTGGAAGTAGC -> TGGAAGTAGCC
TGGAAGTAGCC -> GGAAGTAGCCG
GGAAGTAGCCG -> GAAGTAGCCGG
GAAGTAGCCGG -> AAGTAGCCGGT
AAGTAGCCGGT -> AGTAGCCGGTG
AGTAGCCGGTG -> GTAGCCGGTGA
GTAGCCGGTGA -> TAGCCGGTGAA
TAGCCGGTGAA -> AGCCGGTGAAA
AGCCGGTGAAA -> GCCGGTGAAAG
GCCGGTGAAAG -> CCGGTGAAAGT
CCGGTGAAAGT -> CGGTGAAAGTT
CGGTGAAAGTT -> GGTGAAAGTTG
GGTGAAAGTTG -> GTGAAAGTTGG
GTGAAAGTTGG -> TGAAAGTTGGT
TGAAAGTTGGT -> GAAAGTTGGTA
GAAAGTTGGTA -> AAAGTTGGTAA
AAAGTTGGTAA -> AAGTTGGTAAC
AAGTTGGTAAC -> AGTTGGTAACC
AGTTGGTAACC -> GTTGGTAACCA
GTTGGTAACCA -> TTGGTAACCAG
TTGGTAACCAG -> TGGTAACCAGC
TGGTAACCAGC -> GGTAACCAGCG
GGTAACCAGCG -> GTAACCAGCGG
GTAACCAGCGG -> TAACCAGCGGG
TAACCAGCGGG -> AACCAGCGGGC
AACCAGCGGGC -> ACCAGCGGGCA
CCAGCGGGCAT -> CAGCGGGCATG
CAGCGGGCATG -> AGCGGGCATGG
AGCGGGCATGG -> GCGGGCATGGG
GCGGGCATGGG -> CGGGCATGGGA
CGGGCATGGGA -> GGGCATGGGAC
GGGCATGGGAC -> GGCATGGGACA
GGCATGGGACA -> GCATGGGACAT
GCATGGGACAT -> CATGGGACATC
CATGGGACATC -> ATGGGACATCA
ATGGGACATCA -> TGGGACATCAG
TGGGACATCAG -> GGGACATCAGA
GGGACATCAGA -> GGACATCAGAC
GGACATCAGAC -> GACATCAGACC
GACATCAGACC -> ACATCAGACCT
ACATCAGACCT -> CATCAGACCTA
CATCAGACCTA -> ATCAGACCTAA
ATCAGACCTAA -> TCAGACCTAAC
TCAGACCTAAC -> CAGACCTAACT
CAGACCTAACT -> AGACCTAACTT
AGACCTAACTT -> GACCTAACTTT
GACCTAACTTT -> ACCTAACTTTA
ACCTAACTTTA -> CCTAACTTTAT
CCTAACTTTAT -> CTAACTTTATT
CTAACTTTATT -> TAACTTTATTG
TAACTTTATTG -> AACTTTATTGC
AACTTTATTGC -> ACTTTATTGCG
ACTTTATTGCG -> CTTTATTGCGT
CTTTATTGCGT -> TTTATTGCGTA
TTTATTGCGTA -> TTATTGCGTAC
TTATTGCGTAC -> TATTGCGTACT
TATTGCGTACT -> ATTGCGTACTC
ATTGCGTACTC -> TTGCGTACTCA
TTGCGTACTCA -> TGCGTACTCAA
TGCGTACTCAA -> GCGTACTCAAG
GCGTACTCAAG -> CGTACTCAAGA
CGTACTCAAGA -> GTACTCAAGAG
GTACTCAAGAG -> TACTCAAGAGG
TACTCAAGAGG -> ACTCAAGAGGA
ACTCAAGAGGA -> CTCAAGAGGAC
CTCAAGAGGAC -> TCAAGAGGACG
TCAAGAGGACG -> CAAGAGGACGC
CAAGAGGACGC -> AAGAGGACGCT
AAGAGGACGCT -> AGAGGACGCTA
AGAGGACGCTA -> GAGGACGCTAT
GAGGACGCTAT -> AGGACGCTATG
AGGACGCTATG -> GGACGCTATGC
GGACGCTATGC -> GACGCTATGCA
GACGCTATGCA -> ACGCTATGCAT
ACGCTATGCAT -> CGCTATGCATG
CGCTATGCATG -> GCTATGCATGG
GCTATGCATGG -> CTATGCATGGG
CTATGCATGGG -> TATGCATGGGA
TATGCATGGGA -> ATGCATGGGAC
ATGCATGGGAC -> TGCATGGGACG
TGCATGGGACG -> GCATGGGACGT
GCATGGGACGT -> CATGGGACGTT
CATGGGACGTT -> ATGGGACGTTT
ATGGGACGTTT -> TGGGACGTTTC
TGGGACGTTTC -> GGGACGTTTCG
GGGACGTTTCG -> GGACGTTTCGT
GGACGTTTCGT -> GACGTTTCGTT
GACGTTTCGTT -> ACGTTTCGTTG
ACGTTTCGTTG -> CGTTTCGTTGC
CGTTTCGTTGC -> GTTTCGTTGCA
GTTTCGTTGCA -> TTTCGTTGCAT
TTTCGTTGCAT -> TTCGTTGCATC
TTCGTTGCATC -> TCGTTGCATCT
TCGTTGCATCT -> CGTTGCATCTG
CGTTGCATCTG -> GTTGCATCTGA
GTTGCATCTGA -> TTGCATCTGAC
TTGCATCTGAC -> TGCATCTGACG
TGCATCTGACG -> GCATCTGACGC
GCATCTGACGC -> CATCTGACGCC
CATCTGACGCC -> ATCTGACGCCA
ATCTGACGCCA -> TCTGACGCCAC
TCTGACGCCAC -> CTGACGCCACA
CTGACGCCACA -> TGACGCCACAC
TGACGCCACAC -> GACGCCACACT
GACGCCACACT -> ACGCCACACTA
ACGCCACACTA -> CGCCACACTAA
CGCCACACTAA -> GCCACACTAAG
GCCACACTAAG -> CCACACTAAGT
CCACACTAAGT -> CACACTAAGTA
CACACTAAGTA -> ACACTAAGTAT
ACACTAAGTAT -> CACTAAGTATA
CACTAAGTATA -> ACTAAGTATAA
ACTAAGTATAA -> CTAAGTATAAA
CTAAGTATAAA -> TAAGTATAAAC
TAAGTATAAAC -> AAGTATAAACG
AAGTATAAACG -> AGTATAAACGT
AGTATAAACGT -> GTATAAACGTG
GTATAAACGTG -> TATAAACGTGC
TATAAACGTGC -> ATAAACGTGCC
ATAAACGTGCC -> TAAACGTGCCC
TAAACGTGCCC -> AAACGTGCCCC
AAACGTGCCCC -> AACGTGCCCCC
AACGTGCCCCC -> ACGTGCCCCCT
ACGTGCCCCCT -> CGTGCCCCCTC
CGTGCCCCCTC -> GTGCCCCCTCT
GTGCCCCCTCT -> TGCCCCCTCTC
TGCCCCCTCTC -> GCCCCCTCTCC
GCCCCCTCTCC -> CCCCCTCTCCC
CCCCCTCTCCC -> CCCCTCTCCCG
CCCCTCTCCCG -> CCCTCTCCCGG
CCCTCTCCCGG -> CCTCTCCCGGC
CCTCTCCCGGC -> CTCTCCCGGCT
CTCTCCCGGCT -> TCTCCCGGCTC
TCTCCCGGCTC -> CTCCCGGCTCG
CTCCCGGCTCG -> TCCCGGCTCGG
TCCCGGCTCGG -> CCCGGCTCGGA
CCCGGCTCGGA -> CCGGCTCGGAT
CCGGCTCGGAT -> CGGCTCGGATA
CGGCTCGGATA -> GGCTCGGATAA
GGCTCGGATAA -> GCTCGGATAAG
GCTCGGATAAG -> CTCGGATAAGT
CTCGGATAAGT -> TCGGATAAGTA
TCGGATAAGTA -> CGGATAAGTAA
CGGATAAGTAA -> GGATAAGTAAA
GGATAAGTAAA -> GATAAGTAAAC
GATAAGTAAAC -> ATAAGTAAACT
ATAAGTAAACT -> TAAGTAAACTA
TAAGTAAACTA -> AAGTAAACTAT
AAGTAAACTAT -> AGTAAACTATT
AGTAAACTATT -> GTAAACTATTT
GTAAACTATTT -> TAAACTATTTA
TAAACTATTTA -> AAACTATTTAT
AAACTATTTAT -> AACTATTTATG
AACTATTTATG -> ACTATTTATGC
ACTATTTATGC -> CTATTTATGCA
CTATTTATGCA -> TATTTATGCAT
TATTTATGCAT -> ATTTATGCATC
ATTTATGCATC -> TTTATGCATCA
TTTATGCATCA -> TTATGCATCAC
TTATGCATCAC -> TATGCATCACG
TATGCATCACG -> ATGCATCACGC
ATGCATCACGC -> TGCATCACGCC
TGCATCACGCC -> GCATCACGCCG
GCATCACGCCG -> CATCACGCCGT
CATCACGCCGT -> ATCACGCCGTC
ATCACGCCGTC -> TCACGCCGTCA
TCACGCCGTCA -> CACGCCGTCAA
CACGCCGTCAA -> ACGCCGTCAAA
ACGCCGTCAAA -> CGCCGTCAAAC
CGCCGTCAAAC -> GCCGTCAAACC
GCCGTCAAACC -> CCGTCAAACCC
CCGTCAAACCC -> CGTCAAACCCC
CGTCAAACCCC -> GTCAAACCCCA
GTCAAACCCCA -> TCAAACCCCAC
TCAAACCCCAC -> CAAACCCCACA
CAAACCCCACA -> AAACCCCACAC
AAACCCCACAC -> AACCCCACACG
AACCCCACACG -> ACCCCACACGA
ACCCCACACGA -> CCCCACACGAT
CCCCACACGAT -> CCCACACGATA
CCCACACGATA -> CCACACGATAA
CCACACGATAA -> CACACGATAAC
CACACGATAAC -> ACACGATAACT
ACACGATAACT -> CACGATAACTC
CACGATAACTC -> ACGATAACTCG
ACGATAACTCG -> CGATAACTCGC
CGATAACTCGC -> GATAACTCGCG
GATAACTCGCG -> ATAACTCGCGT
ATAACTCGCGT -> TAACTCGCGTC
TAACTCGCGTC -> AACTCGCGTCC
AACTCGCGTCC -> ACTCGCGTCCA
ACTCGCGTCCA -> CTCGCGTCCAT
CTCGCGTCCAT -> TCGCGTCCATT
TCGCGTCCATT -> CGCGTCCATTG
CGCGTCCATTG -> GCGTCCATTGA
GCGTCCATTGA -> CGTCCATTGAA
CGTCCATTGAA -> GTCCATTGAAC
GTCCATTGAAC -> TCCATTGAACT
TCCATTGAACT -> CCATTGAACTT
CCATTGAACTT -> CATTGAACTTA
CATTGAACTTA -> ATTGAACTTAT
ATTGAACTTAT -> TTGAACTTATT
TTGAACTTATT -> TGAACTTATTG
TGAACTTATTG -> GAACTTATTGT
GAACTTATTGT -> AACTTATTGTC
AACTTATTGTC -> ACTTATTGTCT
ACTTATTGTCT -> CTTATTGTCTA
CTTATTGTCTA -> TTATTGTCTAG
TTATTGTCTAG -> TATTGTCTAGA
TATTGTCTAGA -> ATTGTCTAGAT
ATTGTCTAGAT -> TTGTCTAGATC
TTGTCTAGATC -> TGTCTAGATCG
TGTCTAGATCG -> GTCTAGATCGA
GTCTAGATCGA -> TCTAGATCGAG
TCTAGATCGAG -> CTAGATCGAGT
CTAGATCGAGT -> TAGATCGAGTC
TAGATCGAGTC -> AGATCGAGTCT
AGATCGAGTCT -> GATCGAGTCTG
GATCGAGTCTG -> ATCGAGTCTGA
ATCGAGTCTGA -> TCGAGTCTGAC
TCGAGTCTGAC -> CGAGTCTGACC
CGAGTCTGACC -> GAGTCTGACCT
GAGTCTGACCT -> AGTCTGACCTG
AGTCTGACCTG -> GTCTGACCTGT
GTCTGACCTGT -> TCTGACCTGTC
TCTGACCTGTC -> CTGACCTGTCG
CTGACCTGTCG -> TGACCTGTCGA
TGACCTGTCGA -> GACCTGTCGAA
GACCTGTCGAA -> ACCTGTCGAAG
ACCTGTCGAAG -> CCTGTCGAAGG
CCTGTCGAAGG -> CTGTCGAAGGA
CTGTCGAAGGA -> TGTCGAAGGAG
TGTCGAAGGAG -> GTCGAAGGAGA
GTCGAAGGAGA -> TCGAAGGAGAA
TCGAAGGAGAA -> CGAAGGAGAAG
CGAAGGAGAAG -> GAAGGAGAAGC
GAAGGAGAAGC -> AAGGAGAAGCG
AAGGAGAAGCG -> AGGAGAAGCGA
AGGAGAAGCGA -> GGAGAAGCGAG
GGAGAAGCGAG -> GAGAAGCGAGC
GAGAAGCGAGC -> AGAAGCGAGCT
AGAAGCGAGCT -> GAAGCGAGCTC
GAAGCGAGCTC -> AAGCGAGCTCC
AAGCGAGCTCC -> AGCGAGCTCCC
AGCGAGCTCCC -> GCGAGCTCCCC
GCGAGCTCCCC -> CGAGCTCCCCC
CGAGCTCCCCC -> GAGCTCCCCCG
GAGCTCCCCCG -> AGCTCCCCCGC
AGCTCCCCCGC -> GCTCCCCCGCC
GCTCCCCCGCC -> CTCCCCCGCCC
CTCCCCCGCCC -> TCCCCCGCCCC
TCCCCCGCCCC -> CCCCCGCCCCA
CCCCCGCCCCA -> CCCCGCCCCAG
CCCCGCCCCAG -> CCCGCCCCAGT
CCCGCCCCAGT -> CCGCCCCAGTA
CCGCCCCAGTA -> CGCCCCAGTAC
CGCCCCAGTAC -> GCCCCAGTACG
GCCCCAGTACG -> CCCCAGTACGC
CCCCAGTACGC -> CCCAGTACGCG
CCCAGTACGCG -> CCAGTACGCGA
CCAGTACGCGA -> CAGTACGCGAT
CAGTACGCGAT -> AGTACGCGATG
AGTACGCGATG -> GTACGCGATGT
GTACGCGATGT -> TACGCGATGTA
TACGCGATGTA -> ACGCGATGTAG
ACGCGATGTAG -> CGCGATGTAGG
CGCGATGTAGG -> GCGATGTAGGG
GCGATGTAGGG -> CGATGTAGGGT
CGATGTAGGGT -> GATGTAGGGTG
GATGTAGGGTG -> ATGTAGGGTGC
ATGTAGGGTGC -> TGTAGGGTGCT
TGTAGGGTGCT -> GTAGGGTGCTA
GTAGGGTGCTA -> TAGGGTGCTAT
TAGGGTGCTAT -> AGGGTGCTATT
AGGGTGCTATT -> GGGTGCTATTC
GGGTGCTATTC -> GGTGCTATTCT
GGTGCTATTCT -> GTGCTATTCTT
GTGCTATTCTT -> TGCTATTCTTC
TGCTATTCTTC -> GCTATTCTTCC
GCTATTCTTCC -> CTATTCTTCCT
CTATTCTTCCT -> TATTCTTCCTT
TATTCTTCCTT -> ATTCTTCCTTC
ATTCTTCCTTC -> TTCTTCCTTCT
TTCTTCCTTCT -> TCTTCCTTCTA
TCTTCCTTCTA -> CTTCCTTCTAG
CTTCCTTCTAG -> TTCCTTCTAGT
TTCCTTCTAGT -> TCCTTCTAGTT
TCCTTCTAGTT -> CCTTCTAGTTC
CCTTCTAGTTC -> CTTCTAGTTCT
CTTCTAGTTCT -> TTCTAGTTCTT
TTCTAGTTCTT -> TCTAGTTCTTG
TCTAGTTCTTG -> CTAGTTCTTGA
CTAGTTCTTGA -> TAGTTCTTGAC
TAGTTCTTGAC -> AGTTCTTGACT
AGTTCTTGACT -> GTTCTTGACTA
GTTCTTGACTA -> TTCTTGACTAA
TTCTTGACTAA -> TCTTGACTAAT
TCTTGACTAAT -> CTTGACTAATC
CTTGACTAATC -> TTGACTAATCC
TTGACTAATCC -> TGACTAATCCA
TGACTAATCCA -> GACTAATCCAG
GACTAATCCAG -> ACTAATCCAGG
ACTAATCCAGG -> CTAATCCAGGT
CTAATCCAGGT -> TAATCCAGGTG
TAATCCAGGTG -> AATCCAGGTGT
AATCCAGGTGT -> ATCCAGGTGTA
ATCCAGGTGTA -> TCCAGGTGTAG
TCCAGGTGTAG -> CCAGGTGTAGT
CCAGGTGTAGT -> CAGGTGTAGTG
CAGGTGTAGTG -> AGGTGTAGTGG
AGGTGTAGTGG -> GGTGTAGTGGA
GGTGTAGTGGA -> GTGTAGTGGAT
GTGTAGTGGAT -> TGTAGTGGATT
TGTAGTGGATT -> GTAGTGGATTG
GTAGTGGATTG -> TAGTGGATTGA
TAGTGGATTGA -> AGTGGATTGAT
AGTGGATTGAT -> GTGGATTGATA
GTGGATTGATA -> TGGATTGATAC
TGGATTGATAC -> GGATTGATACG
GGATTGATACG -> GATTGATACGC
GATTGATACGC -> ATTGATACGCC
ATTGATACGCC -> TTGATACGCCT
TTGATACGCCT -> TGATACGCCTT
TGATACGCCTT -> GATACGCCTTA
GATACGCCTTA -> ATACGCCTTAG
ATACGCCTTAG -> TACGCCTTAGC
TACGCCTTAGC -> ACGCCTTAGCA
ACGCCTTAGCA -> CGCCTTAGCAT
CGCCTTAGCAT -> GCCTTAGCATA
GCCTTAGCATA -> CCTTAGCATAC
CCTTAGCATAC -> CTTAGCATACT
CTTAGCATACT -> TTAGCATACTA
TTAGCATACTA -> TAGCATACTAG
TAGCATACTAG -> AGCATACTAGC
AGCATACTAGC -> GCATACTAGCG
GCATACTAGCG -> CATACTAGCGT
CATACTAGCGT -> ATACTAGCGTG
ATACTAGCGTG -> TACTAGCGTGA
TACTAGCGTGA -> ACTAGCGTGAC
ACTAGCGTGAC -> CTAGCGTGACC
CTAGCGTGACC -> TAGCGTGACCA
TAGCGTGACCA -> AGCGTGACCAC
AGCGTGACCAC -> GCGTGACCACG
GCGTGACCACG -> CGTGACCACGA
CGTGACCACGA -> GTGACCACGAC
GTGACCACGAC -> TGACCACGACC
TGACCACGACC -> GACCACGACCA
GACCACGACCA -> ACCACGACCAC
ACCACGACCAC -> CCACGACCACT
CCACGACCACT -> CACGACCACTG
CACGACCACTG -> ACGACCACTGT
ACGACCACTGT -> CGACCACTGTG
CGACCACTGTG -> GACCACTGTGG
GACCACTGTGG -> ACCACTGTGGT
ACCACTGTGGT -> CCACTGTGGTA
CCACTGTGGTA -> CACTGTGGTAT
CACTGTGGTAT -> ACTGTGGTATT
ACTGTGGTATT -> CTGTGGTATTG
CTGTGGTATTG -> TGTGGTATTGA
TGTGGTATTGA -> GTGGTATTGAG
GTGGTATTGAG -> TGGTATTGAGT
TGGTATTGAGT -> GGTATTGAGTG
GGTATTGAGTG -> GTATTGAGTGA
GTATTGAGTGA -> TATTGAGTGAC
TATTGAGTGAC -> ATTGAGTGACG
ATTGAGTGACG -> TTGAGTGACGG
TTGAGTGACGG -> TGAGTGACGGG
TGAGTGACGGG -> GAGTGACGGGA
GAGTGACGGGA -> AGTGACGGGAC
AGTGACGGGAC -> GTGACGGGACC
GTGACGGGACC -> TGACGGGACCA
TGACGGGACCA -> GACGGGACCAC
GACGGGACCAC -> ACGGGACCACA
ACGGGACCACA -> CGGGACCACAG
CGGGACCACAG -> GGGACCACAGC
GGGACCACAGC -> GGACCACAGCT
GGACCACAGCT -> GACCACAGCTT
GACCACAGCTT -> ACCACAGCTTT
ACCACAGCTTT -> CCACAGCTTTT
CCACAGCTTTT -> CACAGCTTTTG
CACAGCTTTTG -> ACAGCTTTTGA
ACAGCTTTTGA -> CAGCTTTTGAG
CAGCTTTTGAG -> AGCTTTTGAGT
AGCTTTTGAGT -> GCTTTTGAGTA
GCTTTTGAGTA -> CTTTTGAGTAA
CTTTTGAGTAA -> TTTTGAGTAAG
TTTTGAGTAAG -> TTTGAGTAAGC
TTTGAGTAAGC -> TTGAGTAAGCC
TTGAGTAAGCC -> TGAGTAAGCCC
TGAGTAAGCCC -> GAGTAAGCCCT
GAGTAAGCCCT -> AGTAAGCCCTG
AGTAAGCCCTG -> GTAAGCCCTGT
GTAAGCCCTGT -> TAAGCCCTGTC
TAAGCCCTGTC -> AAGCCCTGTCT
AAGCCCTGTCT -> AGCCCTGTCTG
AGCCCTGTCTG -> GCCCTGTCTGG
GCCCTGTCTGG -> CCCTGTCTGGG
CCCTGTCTGGG -> CCTGTCTGGGG
CCTGTCTGGGG -> CTGTCTGGGGG
CTGTCTGGGGG -> TGTCTGGGGGG
TGTCTGGGGGG -> GTCTGGGGGGA
GTCTGGGGGGA -> TCTGGGGGGAC
TCTGGGGGGAC -> CTGGGGGGACT
CTGGGGGGACT -> TGGGGGGACTC
TGGGGGGACTC -> GGGGGGACTCT
GGGGGGACTCT -> GGGGGACTCTA
GGGGGACTCTA -> GGGGACTCTAA
GGGGACTCTAA -> GGGACTCTAAA
GGGACTCTAAA -> GGACTCTAAAC
GGACTCTAAAC -> GACTCTAAACA
GACTCTAAACA -> ACTCTAAACAT
ACTCTAAACAT -> CTCTAAACATT
CTCTAAACATT -> TCTAAACATTC
TCTAAACATTC -> CTAAACATTCA
CTAAACATTCA -> TAAACATTCAG
TAAACATTCAG -> AAACATTCAGG
AAACATTCAGG -> AACATTCAGGG
AACATTCAGGG -> ACATTCAGGGG
ACATTCAGGGG -> CATTCAGGGGG
CATTCAGGGGG -> ATTCAGGGGGC
ATTCAGGGGGC -> TTCAGGGGGCG
TTCAGGGGGCG -> TCAGGGGGCGA
TCAGGGGGCGA -> CAGGGGGCGAA
CAGGGGGCGAA -> AGGGGGCGAAA
AGGGGGCGAAA -> GGGGGCGAAAG
GGGGGCGAAAG -> GGGGCGAAAGT
GGGGCGAAAGT -> GGGCGAAAGTG
GGGCGAAAGTG -> GGCGAAAGTGC
GGCGAAAGTGC -> GCGAAAGTGCC
GCGAAAGTGCC -> CGAAAGTGCCA
CGAAAGTGCCA -> GAAAGTGCCAC
GAAAGTGCCAC -> AAAGTGCCACA
AAAGTGCCACA -> AAGTGCCACAA
AAGTGCCACAA -> AGTGCCACAAC
AGTGCCACAAC -> GTGCCACAACC
GTGCCACAACC -> TGCCACAACCT
TGCCACAACCT -> GCCACAACCTA
GCCACAACCTA -> CCACAACCTAC
CCACAACCTAC -> CACAACCTACA
CACAACCTACA -> ACAACCTACAC
ACAACCTACAC -> CAACCTACACA
CAACCTACACA -> AACCTACACAT
AACCTACACAT -> ACCTACACATG
ACCTACACATG -> CCTACACATGT
CCTACACATGT -> CTACACATGTT
CTACACATGTT -> TACACATGTTG
TACACATGTTG -> ACACATGTTGA
ACACATGTTGA -> CACATGTTGAG
CACATGTTGAG -> ACATGTTGAGA
ACATGTTGAGA -> CATGTTGAGAG
CATGTTGAGAG -> ATGTTGAGAGG
ATGTTGAGAGG -> TGTTGAGAGGA
TGTTGAGAGGA -> GTTGAGAGGAT
GTTGAGAGGAT -> TTGAGAGGATT
TTGAGAGGATT -> TGAGAGGATTT
TGAGAGGATTT -> GAGAGGATTTG
GAGAGGATTTG -> AGAGGATTTGA
AGAGGATTTGA -> GAGGATTTGAA
GAGGATTTGAA -> AGGATTTGAAA
AGGATTTGAAA -> GGATTTGAAAA
GGATTTGAAAA -> GATTTGAAAAG
GATTTGAAAAG -> ATTTGAAAAGG
ATTTGAAAAGG -> TTTGAAAAGGT
TTTGAAAAGGT -> TTGAAAAGGTC
TTGAAAAGGTC -> TGAAAAGGTCG
TGAAAAGGTCG -> GAAAAGGTCGT
GAAAAGGTCGT -> AAAAGGTCGTA
AAAAGGTCGTA -> AAAGGTCGTAT
AAAGGTCGTAT -> AAGGTCGTATA
AAGGTCGTATA -> AGGTCGTATAA
AGGTCGTATAA -> GGTCGTATAAC
GGTCGTATAAC -> GTCGTATAACA
GTCGTATAACA -> TCGTATAACAC
TCGTATAACAC -> CGTATAACACC
CGTATAACACC -> GTATAACACCA
GTATAACACCA -> TATAACACCAT
TATAACACCAT -> ATAACACCATG
ATAACACCATG -> TAACACCATGC
TAACACCATGC -> AACACCATGCG
AACACCATGCG -> ACACCATGCGT
ACACCATGCGT -> CACCATGCGTA
CACCATGCGTA -> ACCATGCGTAC
ACCATGCGTAC -> CCATGCGTACA
CCATGCGTACA -> CATGCGTACAT
CATGCGTACAT -> ATGCGTACATG
ATGCGTACATG -> TGCGTACATGT
TGCGTACATGT -> GCGTACATGTA
GCGTACATGTA -> CGTACATGTAC
CGTACATGTAC -> GTACATGTACA
GTACATGTACA -> TACATGTACAC
TACATGTACAC -> ACATGTACACC
ACATGTACACC -> CATGTACACCC
CATGTACACCC -> ATGTACACCCA
ATGTACACCCA -> TGTACACCCAA
TGTACACCCAA -> GTACACCCAAA
GTACACCCAAA -> TACACCCAAAT
TACACCCAAAT -> ACACCCAAATT
ACACCCAAATT -> CACCCAAATTT
CACCCAAATTT -> ACCCAAATTTT
ACCCAAATTTT -> CCCAAATTTTA
CCCAAATTTTA -> CCAAATTTTAG
CCAAATTTTAG -> CAAATTTTAGT
CAAATTTTAGT -> AAATTTTAGTT
AAATTTTAGTT -> AATTTTAGTTG
AATTTTAGTTG -> ATTTTAGTTGA
ATTTTAGTTGA -> TTTTAGTTGAT
TTTTAGTTGAT -> TTTAGTTGATG
TTTAGTTGATG -> TTAGTTGATGA
TTAGTTGATGA -> TAGTTGATGAT
TAGTTGATGAT -> AGTTGATGATC
AGTTGATGATC -> GTTGATGATCG
GTTGATGATCG -> TTGATGATCGG
TTGATGATCGG -> TGATGATCGGT
TGATGATCGGT -> GATGATCGGTT
GATGATCGGTT -> ATGATCGGTTT
ATGATCGGTTT -> TGATCGGTTTT
TGATCGGTTTT -> GATCGGTTTTT
GATCGGTTTTT -> ATCGGTTTTTG
ATCGGTTTTTG -> TCGGTTTTTGA
TCGGTTTTTGA -> CGGTTTTTGAA
CGGTTTTTGAA -> GGTTTTTGAAA
GGTTTTTGAAA -> GTTTTTGAAAT
GTTTTTGAAAT -> TTTTTGAAATT
TTTTTGAAATT -> TTTTGAAATTG
TTTTGAAATTG -> TTTGAAATTGA
TTTGAAATTGA -> TTGAAATTGAC
TTGAAATTGAC -> TGAAATTGACC
TGAAATTGACC -> GAAATTGACCT
GAAATTGACCT -> AAATTGACCTA
AAATTGACCTA -> AATTGACCTAG
AATTGACCTAG -> ATTGACCTAGG
ATTGACCTAGG -> TTGACCTAGGT
TTGACCTAGGT -> TGACCTAGGTG
TGACCTAGGTG -> GACCTAGGTGA
GACCTAGGTGA -> ACCTAGGTGAC
ACCTAGGTGAC -> CCTAGGTGACC
CCTAGGTGACC -> CTAGGTGACCC
CTAGGTGACCC -> TAGGTGACCCA
TAGGTGACCCA -> AGGTGACCCAC
AGGTGACCCAC -> GGTGACCCACT
GGTGACCCACT -> GTGACCCACTT
GTGACCCACTT -> TGACCCACTTG
TGACCCACTTG -> GACCCACTTGG
GACCCACTTGG -> ACCCACTTGGA
ACCCACTTGGA -> CCCACTTGGAT
CCCACTTGGAT -> CCACTTGGATG
CCACTTGGATG -> CACTTGGATGA
CACTTGGATGA -> ACTTGGATGAA
ACTTGGATGAA -> CTTGGATGAAT
CTTGGATGAAT -> TTGGATGAATC
TTGGATGAATC -> TGGATGAATCG
TGGATGAATCG -> GGATGAATCGA
GGATGAATCGA -> GATGAATCGAA
GATGAATCGAA -> ATGAATCGAAG
ATGAATCGAAG -> TGAATCGAAGT
TGAATCGAAGT -> GAATCGAAGTA
GAATCGAAGTA -> AATCGAAGTAG
AATCGAAGTAG -> ATCGAAGTAGT
ATCGAAGTAGT -> TCGAAGTAGTT
TCGAAGTAGTT -> CGAAGTAGTTG
CGAAGTAGTTG -> GAAGTAGTTGA
GAAGTAGTTGA -> AAGTAGTTGAG
AAGTAGTTGAG -> AGTAGTTGAGT
AGTAGTTGAGT -> GTAGTTGAGTT
GTAGTTGAGTT -> TAGTTGAGTTA
TAGTTGAGTTA -> AGTTGAGTTAT
AGTTGAGTTAT -> GTTGAGTTATT
GTTGAGTTATT -> TTGAGTTATTC
TTGAGTTATTC -> TGAGTTATTCT
TGAGTTATTCT -> GAGTTATTCTC
GAGTTATTCTC -> AGTTATTCTCA
AGTTATTCTCA -> GTTATTCTCAT
GTTATTCTCAT -> TTATTCTCATG
TTATTCTCATG -> TATTCTCATGG
TATTCTCATGG -> ATTCTCATGGC
ATTCTCATGGC -> TTCTCATGGCA
TTCTCATGGCA -> TCTCATGGCAT
TCTCATGGCAT -> CTCATGGCATG
CTCATGGCATG -> TCATGGCATGC
TCATGGCATGC -> CATGGCATGCG
CATGGCATGCG -> ATGGCATGCGG
ATGGCATGCGG -> TGGCATGCGGC
TGGCATGCGGC -> GGCATGCGGCT
GGCATGCGGCT -> GCATGCGGCTG
GCATGCGGCTG -> CATGCGGCTGT
CATGCGGCTGT -> ATGCGGCTGTA
ATGCGGCTGTA -> TGCGGCTGTAT
TGCGGCTGTAT -> GCGGCTGTATT
GCGGCTGTATT -> CGGCTGTATTC
CGGCTGTATTC -> GGCTGTATTCC
GGCTGTATTCC -> GCTGTATTCCT
GCTGTATTCCT -> CTGTATTCCTT
CTGTATTCCTT -> TGTATTCCTTA
TGTATTCCTTA -> GTATTCCTTAA
GTATTCCTTAA -> TATTCCTTAAC
TATTCCTTAAC -> ATTCCTTAACT
ATTCCTTAACT -> TTCCTTAACTA
TTCCTTAACTA -> TCCTTAACTAT
TCCTTAACTAT -> CCTTAACTATT
CCTTAACTATT -> CTTAACTATTA
CTTAACTATTA -> TTAACTATTAA
TTAACTATTAA -> TAACTATTAAC
TAACTATTAAC -> AACTATTAACG
AACTATTAACG -> ACTATTAACGG
ACTATTAACGG -> CTATTAACGGT
CTATTAACGGT -> TATTAACGGTG
TATTAACGGTG -> ATTAACGGTGT
ATTAACGGTGT -> TTAACGGTGTC
TTAACGGTGTC -> TAACGGTGTCT
TAACGGTGTCT -> AACGGTGTCTA
AACGGTGTCTA -> ACGGTGTCTAC
ACGGTGTCTAC -> CGGTGTCTACT
CGGTGTCTACT -> GGTGTCTACTT
GGTGTCTACTT -> GTGTCTACTTA
GTGTCTACTTA -> TGTCTACTTAA
TGTCTACTTAA -> GTCTACTTAAG
GTCTACTTAAG -> TCTACTTAAGT
TCTACTTAAGT -> CTACTTAAGTT
CTACTTAAGTT -> TACTTAAGTTA
TACTTAAGTTA -> ACTTAAGTTAC
ACTTAAGTTAC -> CTTAAGTTACG
CTTAAGTTACG -> TTAAGTTACGC
TTAAGTTACGC -> TAAGTTACGCG
TAAGTTACGCG -> AAGTTACGCGA
AAGTTACGCGA -> AGTTACGCGAG
AGTTACGCGAG -> GTTACGCGAGC
GTTACGCGAGC -> TTACGCGAGCG
TTACGCGAGCG -> TACGCGAGCGA
TACGCGAGCGA -> ACGCGAGCGAT
ACGCGAGCGAT -> CGCGAGCGATT
CGCGAGCGATT -> GCGAGCGATTC
GCGAGCGATTC -> CGAGCGATTCG
CGAGCGATTCG -> GAGCGATTCGG
GAGCGATTCGG -> AGCGATTCGGG
AGCGATTCGGG -> GCGATTCGGGA
GCGATTCGGGA -> CGATTCGGGAT
CGATTCGGGAT -> GATTCGGGATT
GATTCGGGATT -> ATTCGGGATTA
ATTCGGGATTA -> TTCGGGATTAC
TTCGGGATTAC -> TCGGGATTACC
TCGGGATTACC -> CGGGATTACCA
CGGGATTACCA -> GGGATTACCAT
GGGATTACCAT -> GGATTACCATG
GGATTACCATG -> GATTACCATGA
GATTACCATGA -> ATTACCATGAA
ATTACCATGAA -> TTACCATGAAA
TTACCATGAAA -> TACCATGAAAA
TACCATGAAAA -> ACCATGAAAAA
ACCATGAAAAA -> CCATGAAAAAC
CCATGAAAAAC -> CATGAAAAACT
CATGAAAAACT -> ATGAAAAACTA
ATGAAAAACTA -> TGAAAAACTAT
TGAAAAACTAT -> GAAAAACTATA
GAAAAACTATA -> AAAAACTATAA
AAAAACTATAA -> AAAACTATAAA
AAAACTATAAA -> AAACTATAAAG
AAACTATAAAG -> AACTATAAAGC
AACTATAAAGC -> ACTATAAAGCT
ACTATAAAGCT -> CTATAAAGCTG
CTATAAAGCTG -> TATAAAGCTGA
TATAAAGCTGA -> ATAAAGCTGAG
ATAAAGCTGAG -> TAAAGCTGAGC
TAAAGCTGAGC -> AAAGCTGAGCG
AAAGCTGAGCG -> AAGCTGAGCGT
AAGCTGAGCGT -> AGCTGAGCGTT
AGCTGAGCGTT -> GCTGAGCGTTT
GCTGAGCGTTT -> CTGAGCGTTTC
CTGAGCGTTTC -> TGAGCGTTTCG
TGAGCGTTTCG -> GAGCGTTTCGC
GAGCGTTTCGC -> AGCGTTTCGCG
AGCGTTTCGCG -> GCGTTTCGCGC
GCGTTTCGCGC -> CGTTTCGCGCA
CGTTTCGCGCA -> GTTTCGCGCAC
GTTTCGCGCAC -> TTTCGCGCACA
TTTCGCGCACA -> TTCGCGCACAT
TTCGCGCACAT -> TCGCGCACATT
TCGCGCACATT -> CGCGCACATTC
CGCGCACATTC -> GCGCACATTCG
GCGCACATTCG -> CGCACATTCGA
CGCACATTCGA -> GCACATTCGAT
GCACATTCGAT -> CACATTCGATT
CACATTCGATT -> ACATTCGATTG
ACATTCGATTG -> CATTCGATTGT
CATTCGATTGT -> ATTCGATTGTC
ATTCGATTGTC -> TTCGATTGTCT
TTCGATTGTCT -> TCGATTGTCTA
TCGATTGTCTA -> CGATTGTCTAA
CGATTGTCTAA -> GATTGTCTAAC
GATTGTCTAAC -> ATTGTCTAACT
ATTGTCTAACT -> TTGTCTAACTC
TTGTCTAACTC -> TGTCTAACTCC
TGTCTAACTCC -> GTCTAACTCCT
GTCTAACTCCT -> TCTAACTCCTC
TCTAACTCCTC -> CTAACTCCTCG
CTAACTCCTCG -> TAACTCCTCGA
TAACTCCTCGA -> AACTCCTCGAA
AACTCCTCGAA -> ACTCCTCGAAC
ACTCCTCGAAC -> CTCCTCGAACG
CTCCTCGAACG -> TCCTCGAACGG
TCCTCGAACGG -> CCTCGAACGGT
CCTCGAACGGT -> CTCGAACGGTG
CTCGAACGGTG -> TCGAACGGTGG
TCGAACGGTGG -> CGAACGGTGGT
CGAACGGTGGT -> GAACGGTGGTC
GAACGGTGGTC -> AACGGTGGTCC
AACGGTGGTCC -> ACGGTGGTCCA
ACGGTGGTCCA -> CGGTGGTCCAC
CGGTGGTCCAC -> GGTGGTCCACA
GGTGGTCCACA -> GTGGTCCACAC
GTGGTCCACAC -> TGGTCCACACC
TGGTCCACACC -> GGTCCACACCT
GGTCCACACCT -> GTCCACACCTA
GTCCACACCTA -> TCCACACCTAA
TCCACACCTAA -> CCACACCTAAG
CCACACCTAAG -> CACACCTAAGC
CACACCTAAGC -> ACACCTAAGCC
ACACCTAAGCC -> CACCTAAGCCT
CACCTAAGCCT -> ACCTAAGCCTG
ACCTAAGCCTG -> CCTAAGCCTGT
CCTAAGCCTGT -> CTAAGCCTGTA
CTAAGCCTGTA -> TAAGCCTGTAG
TAAGCCTGTAG -> AAGCCTGTAGG
AAGCCTGTAGG -> AGCCTGTAGGC
AGCCTGTAGGC -> GCCTGTAGGCC
GCCTGTAGGCC -> CCTGTAGGCCA
CCTGTAGGCCA -> CTGTAGGCCAG
CTGTAGGCCAG -> TGTAGGCCAGC
TGTAGGCCAGC -> GTAGGCCAGCC
GTAGGCCAGCC -> TAGGCCAGCCA
TAGGCCAGCCA -> AGGCCAGCCAA
AGGCCAGCCAA -> GGCCAGCCAAT
GGCCAGCCAAT -> GCCAGCCAATA
GCCAGCCAATA -> CCAGCCAATAA
CCAGCCAATAA -> CAGCCAATAAT
CAGCCAATAAT -> AGCCAATAATT
AGCCAATAATT -> GCCAATAATTT
GCCAATAATTT -> CCAATAATTTT
CCAATAATTTT -> CAATAATTTTC
CAATAATTTTC -> AATAATTTTCT
AATAATTTTCT -> ATAATTTTCTT
ATAATTTTCTT -> TAATTTTCTTC
TAATTTTCTTC -> AATTTTCTTCA
AATTTTCTTCA -> ATTTTCTTCAT
ATTTTCTTCAT -> TTTTCTTCATA
TTTTCTTCATA -> TTTCTTCATAT
TTTCTTCATAT -> TTCTTCATATC
TTCTTCATATC -> TCTTCATATCT
TCTTCATATCT -> CTTCATATCTG
CTTCATATCTG -> TTCATATCTGA
TTCATATCTGA -> TCATATCTGAC
TCATATCTGAC -> CATATCTGACG
CATATCTGACG -> ATATCTGACGT
ATATCTGACGT -> TATCTGACGTC
TATCTGACGTC -> ATCTGACGTCC
ATCTGACGTCC -> TCTGACGTCCT
TCTGACGTCCT -> CTGACGTCCTG
CTGACGTCCTG -> TGACGTCCTGT
TGACGTCCTGT -> GACGTCCTGTC
GACGTCCTGTC -> ACGTCCTGTCG
ACGTCCTGTCG -> CGTCCTGTCGG
CGTCCTGTCGG -> GTCCTGTCGGA
GTCCTGTCGGA -> TCCTGTCGGAA
TCCTGTCGGAA -> CCTGTCGGAAT
CCTGTCGGAAT -> CTGTCGGAATT
CTGTCGGAATT -> TGTCGGAATTA
TGTCGGAATTA -> GTCGGAATTAT
GTCGGAATTAT -> TCGGAATTATG
TCGGAATTATG -> CGGAATTATGT
CGGAATTATGT -> GGAATTATGTG
GGAATTATGTG -> GAATTATGTGA
GAATTATGTGA -> AATTATGTGAC
AATTATGTGAC -> ATTATGTGACA
ATTATGTGACA -> TTATGTGACAA
TTATGTGACAA -> TATGTGACAAA
TATGTGACAAA -> ATGTGACAAAA
ATGTGACAAAA -> TGTGACAAAAG
TGTGACAAAAG -> GTGACAAAAGG
GTGACAAAAGG -> TGACAAAAGGT
TGACAAAAGGT -> GACAAAAGGTC
GACAAAAGGTC -> ACAAAAGGTCC
ACAAAAGGTCC -> CAAAAGGTCCA
CAAAAGGTCCA -> AAAAGGTCCAC
AAAAGGTCCAC -> AAAGGTCCACG
AAAGGTCCACG -> AAGGTCCACGT
AAGGTCCACGT -> AGGTCCACGTC
AGGTCCACGTC -> GGTCCACGTCA
GGTCCACGTCA -> GTCCACGTCAA
GTCCACGTCAA -> TCCACGTCAAT
TCCACGTCAAT -> CCACGTCAATT
CCACGTCAATT -> CACGTCAATTA
CACGTCAATTA -> ACGTCAATTAC
ACGTCAATTAC -> CGTCAATTACC
CGTCAATTACC -> GTCAATTACCT
GTCAATTACCT -> TCAATTACCTC
TCAATTACCTC -> CAATTACCTCG
CAATTACCTCG -> AATTACCTCGT
AATTACCTCGT -> ATTACCTCGTG
ATTACCTCGTG -> TTACCTCGTGT
TTACCTCGTGT -> TACCTCGTGTA
TACCTCGTGTA -> ACCTCGTGTAG
ACCTCGTGTAG -> CCTCGTGTAGC
CCTCGTGTAGC -> CTCGTGTAGCG
CTCGTGTAGCG -> TCGTGTAGCGT
TCGTGTAGCGT -> CGTGTAGCGTA
CGTGTAGCGTA -> GTGTAGCGTAT
GTGTAGCGTAT -> TGTAGCGTATA
TGTAGCGTATA -> GTAGCGTATAA
GTAGCGTATAA -> TAGCGTATAAA
TAGCGTATAAA -> AGCGTATAAAG
AGCGTATAAAG -> GCGTATAAAGC
GCGTATAAAGC -> CGTATAAAGCA
CGTATAAAGCA -> GTATAAAGCAG
GTATAAAGCAG -> TATAAAGCAGA
TATAAAGCAGA -> ATAAAGCAGAG
ATAAAGCAGAG -> TAAAGCAGAGT
TAAAGCAGAGT -> AAAGCAGAGTA
AAAGCAGAGTA -> AAGCAGAGTAA
AAGCAGAGTAA -> AGCAGAGTAAA
AGCAGAGTAAA -> GCAGAGTAAAG
GCAGAGTAAAG -> CAGAGTAAAGC
CAGAGTAAAGC -> AGAGTAAAGCG
AGAGTAAAGCG -> GAGTAAAGCGA
GAGTAAAGCGA -> AGTAAAGCGAC
AGTAAAGCGAC -> GTAAAGCGACT
GTAAAGCGACT -> TAAAGCGACTA
TAAAGCGACTA -> AAAGCGACTAC
AAAGCGACTAC -> AAGCGACTACC
AAGCGACTACC -> AGCGACTACCT
AGCGACTACCT -> GCGACTACCTA
GCGACTACCTA -> CGACTACCTAA
CGACTACCTAA -> GACTACCTAAG
GACTACCTAAG -> ACTACCTAAGT
ACTACCTAAGT -> CTACCTAAGTC
CTACCTAAGTC -> TACCTAAGTCG
TACCTAAGTCG -> ACCTAAGTCGG
ACCTAAGTCGG -> CCTAAGTCGGC
CCTAAGTCGGC -> CTAAGTCGGCG
CTAAGTCGGCG -> TAAGTCGGCGT
TAAGTCGGCGT -> AAGTCGGCGTT
AAGTCGGCGTT -> AGTCGGCGTTA
AGTCGGCGTTA -> GTCGGCGTTAA
GTCGGCGTTAA -> TCGGCGTTAAA
TCGGCGTTAAA -> CGGCGTTAAAA
CGGCGTTAAAA -> GGCGTTAAAAG
GGCGTTAAAAG -> GCGTTAAAAGG
GCGTTAAAAGG -> CGTTAAAAGGC
CGTTAAAAGGC -> GTTAAAAGGCG
GTTAAAAGGCG -> TTAAAAGGCGT
TTAAAAGGCGT -> TAAAAGGCGTG
TAAAAGGCGTG -> AAAAGGCGTGA
AAAAGGCGTGA -> AAAGGCGTGAC
AAAGGCGTGAC -> AAGGCGTGACT
AAGGCGTGACT -> AGGCGTGACTA
AGGCGTGACTA -> GGCGTGACTAT
GGCGTGACTAT -> GCGTGACTATC
GCGTGACTATC -> CGTGACTATCG
CGTGACTATCG -> GTGACTATCGT
GTGACTATCGT -> TGACTATCGTC
TGACTATCGTC -> GACTATCGTCC
GACTATCGTCC -> ACTATCGTCCC
ACTATCGTCCC -> CTATCGTCCCA
CTATCGTCCCA -> TATCGTCCCAT
TATCGTCCCAT -> ATCGTCCCATT
ATCGTCCCATT -> TCGTCCCATTA
TCGTCCCATTA -> CGTCCCATTAG
CGTCCCATTAG -> GTCCCATTAGC
GTCCCATTAGC -> TCCCATTAGCA
TCCCATTAGCA -> CCCATTAGCAA
CCCATTAGCAA -> CCATTAGCAAC
CCATTAGCAAC -> CATTAGCAACC
CATTAGCAACC -> ATTAGCAACCG
ATTAGCAACCG -> TTAGCAACCGG
TTAGCAACCGG -> TAGCAACCGGC
TAGCAACCGGC -> AGCAACCGGCA
AGCAACCGGCA -> GCAACCGGCAT
GCAACCGGCAT -> CAACCGGCATG
CAACCGGCATG -> AACCGGCATGT
AACCGGCATGT -> ACCGGCATGTG
ACCGGCATGTG -> CCGGCATGTGG
CCGGCATGTGG -> CGGCATGTGGA
CGGCATGTGGA -> GGCATGTGGAC
GGCATGTGGAC -> GCATGTGGACC
GCATGTGGACC -> CATGTGGACCG
CATGTGGACCG -> ATGTGGACCGT
ATGTGGACCGT -> TGTGGACCGTC
TGTGGACCGTC -> GTGGACCGTCA
GTGGACCGTCA -> TGGACCGTCAG
TGGACCGTCAG -> GGACCGTCAGC
GGACCGTCAGC -> GACCGTCAGCC
GACCGTCAGCC -> ACCGTCAGCCT
ACCGTCAGCCT -> CCGTCAGCCTT
CCGTCAGCCTT -> CGTCAGCCTTT
CGTCAGCCTTT -> GTCAGCCTTTC
GTCAGCCTTTC -> TCAGCCTTTCG
TCAGCCTTTCG -> CAGCCTTTCGT
CAGCCTTTCGT -> AGCCTTTCGTA
AGCCTTTCGTA -> GCCTTTCGTAG
GCCTTTCGTAG -> CCTTTCGTAGT
CCTTTCGTAGT -> CTTTCGTAGTT
CTTTCGTAGTT -> TTTCGTAGTTT
TTTCGTAGTTT -> TTCGTAGTTTC
TTCGTAGTTTC -> TCGTAGTTTCG
TCGTAGTTTCG -> CGTAGTTTCGT
CGTAGTTTCGT -> GTAGTTTCGTT
GTAGTTTCGTT -> TAGTTTCGTTC
TAGTTTCGTTC -> AGTTTCGTTCC
AGTTTCGTTCC -> GTTTCGTTCCT
GTTTCGTTCCT -> TTTCGTTCCTA
TTTCGTTCCTA -> TTCGTTCCTAG
TTCGTTCCTAG -> TCGTTCCTAGA
TCGTTCCTAGA -> CGTTCCTAGAC
CGTTCCTAGAC -> GTTCCTAGACA
GTTCCTAGACA -> TTCCTAGACAG
TTCCTAGACAG -> TCCTAGACAGA
TCCTAGACAGA -> CCTAGACAGAC
CCTAGACAGAC -> CTAGACAGACA
CTAGACAGACA -> TAGACAGACAT
TAGACAGACAT -> AGACAGACATT
AGACAGACATT -> GACAGACATTC
GACAGACATTC -> ACAGACATTCC
ACAGACATTCC -> CAGACATTCCG
CAGACATTCCG -> AGACATTCCGG
AGACATTCCGG -> GACATTCCGGA
GACATTCCGGA -> ACATTCCGGAT
ACATTCCGGAT -> CATTCCGGATT
CATTCCGGATT -> ATTCCGGATTT
ATTCCGGATTT -> TTCCGGATTTT
TTCCGGATTTT -> TCCGGATTTTT
TCCGGATTTTT -> CCGGATTTTTG
CCGGATTTTTG -> CGGATTTTTGC
CGGATTTTTGC -> GGATTTTTGCA
GGATTTTTGCA -> GATTTTTGCAG
GATTTTTGCAG -> ATTTTTGCAGC
ATTTTTGCAGC -> TTTTTGCAGCC
TTTTTGCAGCC -> TTTTGCAGCCA
TTTTGCAGCCA -> TTTGCAGCCAC
TTTGCAGCCAC -> TTGCAGCCACT
TTGCAGCCACT -> TGCAGCCACTC
TGCAGCCACTC -> GCAGCCACTCA
GCAGCCACTCA -> CAGCCACTCAC
CAGCCACTCAC -> AGCCACTCACC
AGCCACTCACC -> GCCACTCACCG
GCCACTCACCG -> CCACTCACCGC
CCACTCACCGC -> CACTCACCGCT
CACTCACCGCT -> ACTCACCGCTA
ACTCACCGCTA -> CTCACCGCTAG
CTCACCGCTAG -> TCACCGCTAGC
TCACCGCTAGC -> CACCGCTAGCC
CACCGCTAGCC -> ACCGCTAGCCA
ACCGCTAGCCA -> CCGCTAGCCAA
CCGCTAGCCAA -> CGCTAGCCAAC
CGCTAGCCAAC -> GCTAGCCAACG
GCTAGCCAACG -> CTAGCCAACGC
CTAGCCAACGC -> TAGCCAACGCT
TAGCCAACGCT -> AGCCAACGCTA
AGCCAACGCTA -> GCCAACGCTAA
GCCAACGCTAA -> CCAACGCTAAC
CCAACGCTAAC -> CAACGCTAACC
CAACGCTAACC -> AACGCTAACCA
AACGCTAACCA -> ACGCTAACCAA
ACGCTAACCAA -> CGCTAACCAAA
CGCTAACCAAA -> GCTAACCAAAG
GCTAACCAAAG -> CTAACCAAAGG
CTAACCAAAGG -> TAACCAAAGGG
TAACCAAAGGG -> AACCAAAGGGT
AACCAAAGGGT -> ACCAAAGGGTC
ACCAAAGGGTC -> CCAAAGGGTCC
CCAAAGGGTCC -> CAAAGGGTCCC
CAAAGGGTCCC -> AAAGGGTCCCG
AAAGGGTCCCG -> AAGGGTCCCGC
AAGGGTCCCGC -> AGGGTCCCGCA
AGGGTCCCGCA -> GGGTCCCGCAT
GGGTCCCGCAT -> GGTCCCGCATC
GGTCCCGCATC -> GTCCCGCATCG
GTCCCGCATCG -> TCCCGCATCGC
TCCCGCATCGC -> CCCGCATCGCC
CCCGCATCGCC -> CCGCATCGCCC
CCGCATCGCCC -> CGCATCGCCCG
CGCATCGCCCG -> GCATCGCCCGG
GCATCGCCCGG -> CATCGCCCGGC
CATCGCCCGGC -> ATCGCCCGGCT
ATCGCCCGGCT -> TCGCCCGGCTC
TCGCCCGGCTC -> CGCCCGGCTCT
CGCCCGGCTCT -> GCCCGGCTCTG
GCCCGGCTCTG -> CCCGGCTCTGG
CCCGGCTCTGG -> CCGGCTCTGGG
CCGGCTCTGGG -> CGGCTCTGGGT
CGGCTCTGGGT -> GGCTCTGGGTC
GGCTCTGGGTC -> GCTCTGGGTCC
GCTCTGGGTCC -> CTCTGGGTCCC
CTCTGGGTCCC -> TCTGGGTCCCA
TCTGGGTCCCA -> CTGGGTCCCAA
CTGGGTCCCAA -> TGGGTCCCAAG
TGGGTCCCAAG -> GGGTCCCAAGG
GGGTCCCAAGG -> GGTCCCAAGGG
GGTCCCAAGGG -> GTCCCAAGGGG
GTCCCAAGGGG -> TCCCAAGGGGA
TCCCAAGGGGA -> CCCAAGGGGAC
CCCAAGGGGAC -> CCAAGGGGACA
CCAAGGGGACA -> CAAGGGGACAC
CAAGGGGACAC -> AAGGGGACACA
AAGGGGACACA -> AGGGGACACAA
AGGGGACACAA -> GGGGACACAAA
GGGGACACAAA -> GGGACACAAAC
GGGACACAAAC -> GGACACAAACA
GGACACAAACA -> GACACAAACAT
GACACAAACAT -> ACACAAACATC
ACACAAACATC -> CACAAACATCA
CACAAACATCA -> ACAAACATCAT
ACAAACATCAT -> CAAACATCATA
CAAACATCATA -> AAACATCATAG
AAACATCATAG -> AACATCATAGT
AACATCATAGT -> ACATCATAGTA
ACATCATAGTA -> CATCATAGTAG
CATCATAGTAG -> ATCATAGTAGC
ATCATAGTAGC -> TCATAGTAGCT
TCATAGTAGCT -> CATAGTAGCTG
CATAGTAGCTG -> ATAGTAGCTGT
ATAGTAGCTGT -> TAGTAGCTGTT
TAGTAGCTGTT -> AGTAGCTGTTA
AGTAGCTGTTA -> GTAGCTGTTAT
GTAGCTGTTAT -> TAGCTGTTATC
TAGCTGTTATC -> AGCTGTTATCT
AGCTGTTATCT -> GCTGTTATCTC
GCTGTTATCTC -> CTGTTATCTCC
CTGTTATCTCC -> TGTTATCTCCA
TGTTATCTCCA -> GTTATCTCCAC
GTTATCTCCAC -> TTATCTCCACG
TTATCTCCACG -> TATCTCCACGC
TATCTCCACGC -> ATCTCCACGCT
ATCTCCACGCT -> TCTCCACGCTT
TCTCCACGCTT -> CTCCACGCTTT
CTCCACGCTTT -> TCCACGCTTTG
TCCACGCTTTG -> CCACGCTTTGT
CCACGCTTTGT -> CACGCTTTGTA
CACGCTTTGTA -> ACGCTTTGTAA
ACGCTTTGTAA -> CGCTTTGTAAT
CGCTTTGTAAT -> GCTTTGTAATA
GCTTTGTAATA -> CTTTGTAATAC
CTTTGTAATAC -> TTTGTAATACC
TTTGTAATACC -> TTGTAATACCC
TTGTAATACCC -> TGTAATACCCG
TGTAATACCCG -> GTAATACCCGG
GTAATACCCGG -> TAATACCCGGT
TAATACCCGGT -> AATACCCGGTG
AATACCCGGTG -> ATACCCGGTGT
ATACCCGGTGT -> TACCCGGTGTT
TACCCGGTGTT -> ACCCGGTGTTA
ACCCGGTGTTA -> CCCGGTGTTAT
CCCGGTGTTAT -> CCGGTGTTATT
CCGGTGTTATT -> CGGTGTTATTA
CGGTGTTATTA -> GGTGTTATTAT
GGTGTTATTAT -> GTGTTATTATC
GTGTTATTATC -> TGTTATTATCT
TGTTATTATCT -> GTTATTATCTA
GTTATTATCTA -> TTATTATCTAA
TTATTATCTAA -> TATTATCTAAA
TATTATCTAAA -> ATTATCTAAAT
ATTATCTAAAT -> TTATCTAAATG
TTATCTAAATG -> TATCTAAATGG
TATCTAAATGG -> ATCTAAATGGC
ATCTAAATGGC -> TCTAAATGGCA
TCTAAATGGCA -> CTAAATGGCAT
CTAAATGGCAT -> TAAATGGCATG
TAAATGGCATG -> AAATGGCATGA
AAATGGCATGA -> AATGGCATGAC